Gs, Gs, Gs, Re, Gs, Gs, Gs, Gs, Gs, Gd, Gd, Gd, Gd, Gs, Gs, Gll^Fp, Gs^Fms, Ww, Ww, Gs^Fp, Gs, Gs^Fp, Gd, Gg, Gs, Gg, Gd, Gg, Gll^Em, Gll^Fdf, Gll^Fdf, Gll^Fdf, Gd, Gs, Gd, Gg, Gs, Gg, Gll^Fdf, Gg
Gs, Gs, Gd, Gs, Ce, Gd, Gs, Gs, Gs, Gs, Gs^Em, Gs, Gs, Gd, Gd, Gll^Fp, Gll^Fp, Gs^Fp, Ww, Gll^Fmf, Gs^Vh, Gs^Fp, Gd, Gs, Gs, Gs, Gs, Gll^Fmf, Gll, Gll^Fmf, Gll^Fdf, Gll^Fdf, Gd, Gs, Gd, Gd, Gs, Gll, Gll^Fdf, Gg
Gs, Gs, Ce, 2 Ke, Ce, Gs, Gs, Gs, Hh, Hh, Hh, Hh, Gs^Vh, Gs, Gs, Gd, Gll^Fmf, Gll^Fp, Gll^Fmf, Gs^Fp, Gll^Fmf, Gll^Fmf, Gll^Fmf, Gd, Gs, Gs, Gs, Gs, Gs, Gll, Gs, Gg^Vh, Hh, Gd, Gs, Gs, Gs, Gll, Gll, Gll^Fdf
Gs, Gd, Re, Ce, Gs, Gs, Gs, Gs, Gs, Hh, Gs, Hh, Gs, Gs, Gd, Gs, Gs, Gll^Fp, Gd, Gs^Fp, Gll^Fp, Gd^Em, Gll^Fp, Gll^Fp, Gd, Gs, Gs, Gs, Gs, Gs, Gs, Gs, Hh, Gs, Gs, Gs, Gd, Gs, Gs, Gs
Gs, Gs, Re, Gd, Gs, Gs, Gs, Gs, Gd, Gs, Gs, Gs, Gd, Gs, Gs, Gs, Gs, Gd, Gd, Gd, Gs, Gs, Gs, Gs^Fp, Gs, Gd, Gd, Gd, Gs, Gd, Gd, Hh, Gs, Hh, Hh, Gs, Gll, Gd, Gs, Gg
Gs, Gs, Gd, Re, Hh, Hh, Gs, Gd, Gs, Gd, Gd, Gd, Gs, Gs, Gs, Gs, Gs, Gs, Hh, Gs, Gd, Gd, Gd, Gs, Gll^Fmf, Hh, Hh, Gd, Hh, Gs, Gs, Gd, Gs, Hh, Gd, Gd, Gll, Gll^Fdf, Gs, Gs
Gs, Gs, Gs^Vh, Re, Gs, Gs, Gs, Gs, Gd, Gd, Gs, Gs, Gs, Gs, Gs, Gs, Gs, Hh, Gs, Hh, Gll, Gd, Gll, Gd, Gll, Gll^Fmf, Gll^Em, Hh, Gs, Hh, Gs, Gs, Gs, Gs, Gs, Gd, Gs, Gll, Gs, Gg^Efm
Gs, Gs, Re, Re, Gs, Gs, Gs, Gs, Gd, Gd, Gs, Gs, Gs, Gs, Gll^Fmf, Gs, Gs, Gs, Gll^Em, Gll, Gll^Fdf, Gll^Fmf, Gll^Fdf, Gll^Fdf, Gll^Fdf, Gll^Fdf, Gll^Fdf, Gll^Fdf, Gll^Fdf, Gll^Fdf, Gs, Gs, Gs, Gs, Gd, Gd, Gs, Gs, Gs, Gs
Gs, Gs, Re, Gs, Gs, Gs, Gs, Gs, Gs, Gs, Gs, Gs, Gll^Fdf, Gll^Fdf, Gll^Fdf, Gll^Fdf, Gs, Gs, Gll^Fdf, Gll^Fdf, Gll^Fdf, Gll^Fdf, Gll^Fdf, Gll^Fdf, Gll^Fdf, Gll^Fdf, Gll^Fdf, Gll^Fdf, Gs, Gs, Gs, Gs, Gs, Gd, Gs, Gd, Gs, Gs, Gd^Vh, Gs
Gs, Gs, Gs, Re, Re, Gs, Gs, Gd, Gs, Gs, Gll, Gll, Gll^Fdf, Gll^Fdf, Gs^Vl, Gs, Gs, Gs, Gs, Gll^Fdf, Gll, Gll, Gs, Gs^Vc, Gll^Fdf, Gll^Fdf, Gll, Gll, Gs, Gs, Gs, Gs, Gs, Gs, Hh, Gs, Gs, Gs, Gs, Gs
Gs, Gd, Gs, Gs, Re, Gs, Gs, Gd, Gs, Gs, Gll, Gll^Fdf, Gll^Fdf, Gll^Fdf, Gs, Gs, Rb^Gvs, Rb^Gvs, Rb^Gvs, Gs, Gs, Gs, Re, Gll, Gll^Fdf, Gll^Fdf, Gll^Fdf, Gll, Gll, Gs, Gd, Gd, Hh, Hh, Gg^Vh, Hh, Gd, Gd, Hh, Hh
Gs, Gd, Gd, Gs, Gs, Re, Gs, Gd, Gs, Gs, Gll, Gll^Fdf, Gll^Fdf, Gll^Fdf, Gs, Gs, Rb^Gvs, Rb^Gvs, Gs, Gd^Vh, Re, Gs, Gs, Gll^Fdf, Rb^Gvs, Gll^Fdf, Gd^Vh, Gll^Fdf, Gll^Fdf, Gs, Gs, Gd, Gs, Hh, Hh, Gs, Hh, Gd, Gs, Hh
Gs, Gs, Gd, Gs, Gs, Re, Re, Gd, Gs, Gs, Gll, Gll^Fdf, Gll, Gs^Vl, Rd, Gs, Gs, Gs, Re, Re, Gs, Re, Gs, Gs, Rb^Gvs, Rb^Gvs, Rb^Gvs, Gs, Gll^Fdf, Gs, Gs, Gd, Gs, Gs, Gs, Gs, Gs, Gd, Gd, Hh
Gs, Gs, Gs, Gd, Gd, Gs, Re, Gs, Gs, Gd, Gd, Gs, Gs, Gs, Gs, Re, Re, Gs, Re, Gs, Ch, Gs, Rp, Gs, Gs, Rb^Gvs, Gs, Gs, Gs, Gs, Gs, Gd, Gd, Gs, Gs, Gll, Gll^Fdf, Gs, Gd, Gs
Hh, Hh, Hh, Gs, Gs, Gs, Re, Gs, Gs, Gd, Gs, Gs, Gs, Gs, Re, Re, Gs, Re, Rr, Ch, 1 Kh, Ch, Rr, Re, Re, Gs, Re, Re, Re, Gs, Gs, Gs, Gs, Gd, Gs, Gll^Fdf, Gll, Gll^Fdf, Gll, Gs
Hh, Hh, Hh, Gs, Gs, Gs, Gs, Rb, Rb, Gs, Re, Re, Re, Re, Gs, Gs, Gd, Ch, Rr^Vhc, Rrc, Rrc, Rrc, Rr^Vhc, Re, Gd, Re, Gs, Gs, Gs, Re, Re, Re, Re, Gs, Gs, Gs, Gs, Gll^Fdf, Gll, Gs
Gs, Gs^Em, Gs, Gs, Gs, Gs, Gs, Gd^Vh, Rb, Gs, Gs, Gd, Gs, Re, Rd, Gs, Gs, Ch, Rr, Rrc, Rr, Rrc, Re, Ch, Gs, Gs, Gd, Gd, Gs, Gs, Gs, Gs, Gs, Re, Re, Gd, Gd, Gd, Gs, Gs
Gs, Gd, Gd, Gs, Re, Gs, Re, Re, Gs, Gs, Gll^Fdf, Gs, Gs, Gs, Gs, Re, Re, Re, Re, Ch, Rp, Ch, Re, Gd, Gd, Gd, Gs, Gs, Gd, Gd, Gd, Gs, Gs, Gs, Gs, Re, Re, Gd^Vh, Hh, Gs
Gs, Gd, Re, Re, Gs, Re, Gs, Gs, Gd, Gs, Gs, Gll, Gs, Gll^Fdf, Gd^Vh, Rd, Gs, Gs, Gs, Gs, Gd, Gs, Gs, Re, Gs, Gs, Rb^Gvs, Gll, Gd, Gd, Gs, Gd, Gs, Gs, Gd, Gs, Re, Gs, Gs, Hh
Re, Re, Gs, Gs, Gs, Gd, Gd, Gs, Gs, Gd, Gd, Gs, Gs, Gll^Fdf, Gs, Gs, Gd, Gs, Gs, Gd, Gs, Gs, Rb^Gvs, Rb^Gvs, Rb^Gvs, Rb^Gvs, Rb^Gvs, Gll^Fdf, Gs^Vh, Gd, Gs, Gll, Gll, Gs, Gd, Gs, Gs, Re, Re, Gll^Fdf
Gs, Gs, Gd, Gs, Gd, Gd, Gs, Gd, Gll^Fdf, Gll, Gll^Fdf, Gd, Gd, Gd, Gd, Gd, Gd, Gll, Gll^Fdf, Gd^Vh, Gll, Gs, Gs, Rb^Gvs, Rb^Gvs, Rb^Gvs, Gs, Gll, Gs, Gd, Gs, Gll^Fdf, Gs, Gd, Gs, Gll^Em, Gll^Fdf, Gs, Re, Gs
Gs, Gd, Gd, Gs, Gd, Gll, Gll, Gll^Fdf, Gll, Gll^Fdf, Gll^Vh, Gll^Fdf, Gll, Gd, Gs, Gd, Gd, Gs, Gll^Fdf, Gll^Fdf, Gll^Fdf, Gll^Fdf, Gll^Fdf, Gll^Fdf, Gs, Gs, Gll, Gll, Gll^Fdf, Gd, Gd, Gll, Gd, Gd, Gs, Hh, Gll^Fdf, Gll, Gs, Re
Gs, Gs, Gd, Gd, Gs, Gll^Fdf, Gll, Gll, Gll^Fdf, Gll^Em, Gll^Fdf, Gll^Fdf, Gll^Fdf, Gll, Gs, Gd, Gd, Gs, Gll^Fdf, Gll^Fdf, Gll^Fdf, Gll^Fdf, Gll, Gll, Gs, Gll, Gll^Fdf, Gll^Fdf, Gll^Fdf, Gll, Gs, Gd, Gd, Gd, Gs, Hh, Hh, Gll^Fdf, Gs, Re
Gs, Gs, Gg, Gd, Gs, Gll^Fdf, Gll^Fdf, Gll, Gll^Fdf, Gll, Gll^Fdf, Gll^Fdf, Gll^Fdf, Gll^Fdf, Gg, Gd, Gs, Gll, Gg, Gll, Gg, Gll, Gg, Gs, Gs^Vh, Gll, Gll, Gll, Gg, Gll, Gs, Gs, Gs, Gd, Gs, Gd, Gg, Gll, Gs, Re
