Wo, Wo, Wo, Wo, Wo, Wo, Wo, Wo, Wo, Wo, Wo, Ww, Ww, Ww, Ds, Gs, Gs, Gll^Fdf, Gll^Fdf, Gll^Fdf, Gll^Fdf, Gll^Fdf, Gll^Fdf, Gll^Fdf, Gll^Fdf, Gll^Fdf, Gll^Fdf, Gll^Fdf, Gll^Fdf, Gll, Gll^Fdf, Gll, Gll^Fdf, Gll^Fdf, Gll^Fdf, Gs, Gd, Gs, Gs, Gll^Fdf, Gll, Gs, Gll, Gs, Gs, Gs
Wo, Wo, Wo, Wo, Wo, Wo, Wo, Wo, Wo, Wo, Ww, Ww, Ww, Ds, Gs, Gs, Gll^Fdf, Gll^Fdf, Gll^Fdf, Gll^Fdf, Gll^Fdf, Gll^Fdf, Gd, Gs, Gs, Gs, Gs, Gll, Gll, Gll^Fdf, Gll, Gll^Fdf, Gll, Gll, Gll, Gll, Gd, Gs, Gs, Gll^Fdf, Gll^Fdf, Gs, Gll^Fdf, Gll^Fdf, Gll^Fdf, Gs
Wo, Wo, Wo, Wo, Wo, Wo, Ww, Wo, Ww, Ww, Ww, Ww, Gs, Ds, Gs, Gs, Gll^Fdf, Gll^Fdf, Gll^Fdf, Gll^Fdf, Gll, Gs, Gs, Gd, Gs, Gd, Gd, Gs, Gs, Gll, Gd, Gs, Gd, Gd, Gs, Gd, Gll, Gs, Gll^Fmf, Gll^Fmf, Gll^Fdf, Gll^Fdf, Gll, Gll^Es, Gll^Fdf, Gll^Fdf
Wo, Wo, Wo, Wo, Wo, Wo, Ww, Ww, Ww, Ww, Ds, Gs, Gs, Gs, Gd, Gll^Fdf, Gll^Fdf, Gll^Fdf, Gll^Fmf, Gll^Fmf, Gll, Gs, Gs, Gs, Gs, Gd, Gs, Gd, Gs, Gs, Gs, Gs, Gs, Gll^Fmf, Gll^Fdf, Gll^Fmf, Gll^Fmf, Gll^Fmf, Gll^Fdf, Gll^Fmf, Gll, Gll^Fdf, Gll, Gll, Gll^Fdf, Gll^Fdf
Wo, Wo, Wo, Wo, Gs, Gs, Ww, Ww, Ds, Ww, Ds, Ds, Gs, Gd, Gs, Gll^Fdf, Gll^Fdf, Gll^Fmf, Gll^Fdf, Gll, Gs, Gs, Hh, Hh^Es, Gs, Gs, Gll, Gs, Gll^Fdf, Gs, Gs, Gs, Gs, Gs, Gs, Gll^Fdf, Gll, Gll^Fdf, Gll, Gll^Fdf, Gll^Fmf, Gll^Fdf, Gll^Fdf, Gll^Fdf, Gll^Fdf, Gll^Fdf
Wo, Wo, Wo, Wo, Ww, Ds, Ww, Ww, Ds, Ds, Gs, Gs, Gd, Gd, Gs, Gll^Fdf, Gll^Fdf, Gll^Fdf, Gs, Gs, Gd, Gs, Gs, Gs, Gd, Gs, Gll^Fdf, Gll^Fdf, Gll^Fmf, Gll^Fdf, Gll, Gd, Gs, Gs, Gs, Gll^Fdf, Gll^Fdf, Gll^Fmf, Gll^Fmf, Gll, Gll^Fdf, Gll^Es, Gll, Gll^Fdf, Gll^Fdf, Gll^Fdf
Wo, Wo, Wo, Ww, Ww, Ww, Ds, Ds, Ds, Gs, Gs, Gs, Gd, Gs, Gs, Gll^Fdf, Gll^Fdf, Gll, Gd, Gd, Gs, Gd, Gd, Gd, Gs, Gll^Fmf, Gll, Gll, Gd, Gll, Gs, Gd, Gd, Hh, Gs, Gll, Gll, Gll^Fmf, Gll^Fdf, Gs, Gll^Fdf, Gll, Gll^Fdf, Gll^Fmf, Gll^Fdf, Gll^Fdf
Wo, Wo, Wo, Ww, Ww, Ww, Ds, Ds, Gs, Gs, Gs, Gd, Gd, Gd, Gs, Gs, Gs, Gs, Gd, Gd, Re, Gd, Gs, Gd, Gd, Gs, Gs^Es, Gd, Gd, Gd, Gd, Gd, Gs, Hh, Hh, Gs, Gs, Gll^Fdf, Gll^Fdf, Gll, Gll^Fdf, Gll^Fmf, Gll^Fdf, Gll^Fdf, Gll^Fdf, Gll^Fdf
Wo, Wo, Wo, Ww, Ww, Ww, Ds, Ds, Gs, Gs, Gs, Gd, Gd, Gs, Gd, Gd, Gd, Gd, Gs, Gs, Gs, Gs^Esd, Gs, Gd, Gd, Gs, Gd, Gs, Gs, Gs, Gd, Gs, Gs^Esd, Hh, Hh^Es, Hh, Gs, Gll, Gll, Gll^Fdf, Gll^Fmf, Gll^Fdf, Gll^Fdf, Gll^Fmf, Gll^Fdf, Gll^Fdf
Wo, Wo, Ww, Ww, Ww, Ww, Gs, Gs, Gs, Gs, Gs, Gd, Gs, Gd, Gs, Gs, Gll, Gs, Gll, Gs, Gd, Gs, Gll^Fdf, Gs, Gs, Gd, Gd, Gd, Gs, Gs, Gd, Gs, Gs, Gd, Hh, Hh, Hh, Gs, Gs, Gll^Fdf, Gll, Gll^Fdf, Gll^Fdf, Gll, Gll, Gll^Fdf
Wo, Wo, Ww, Ww, Ww, Ds, Gs, Gs, Gs, Gs, Gll, Gs, Gll^Fmf, Gll, Gll^Fmf, Gll^Fmf, Gll^Fdf, Gll^Fdf, Gs, Gs, Re, Gs, Gs, Gs, Gll, Gll^Fdf, Gll^Fdf, Gll^Fdf, Gll^Fdf, Gd, Gd, Gd, Gd, Gd, Gd, Hh, Gd, Hh, Gs, Gs, Gs, Gll, Gll^Fdf, Gll^Fdf, Gll^Fdf, Gll^Fdf
Wo, Wo, Ww, Ww, Ww, Ds, Gs, Gs, Gll, Gll^Fdf, Gll^Fdf, Gll^Fmf, Gll^Fdf, Gll^Fmf, Gll^Fdf, Gll^Fdf, Ce, Ce, Ce, Re, Gs, Gs, Gll, Gll, Gll^Fdf, Gll^Fdf, Gll^Fdf, Gll^Fdf, Gll^Fdf, Gll^Fdf, Gs, Gs, Gs, Gd, Gs, Gd, Gs, Gd, Gs, Gs, Gs, Gll, Gll^Fmf, Gll^Fdf, Gll^Es, Gll^Fdf
Wo, Wo, Ww, Ww, Ww, Ds, Ds, Gs, Gs, Gll^Fdf, Gll, Gll^Fdf, Gs, Gs, Gs^Esd, Re, Ce, Ke, Rb, Rb, Gd, Gs, Gs, Gll^Fdf, Gll, Gll^Fdf, Gll, Gll^Fdf, Gll^Fdf, Gll^Fdf, Gll, Gs, Re, Ce, Re, Gs^Es, Gll^Fmf, Gs, Gll, Gs, Gs, Gll, Gll^Fdf, Gll^Fdf, Gll^Fdf, Gll^Fdf
Wo, Wo, Wo, Ww, Ww, Ds, Gs, Gs, Gs, Gs, Gs, Gs, Gs, Gs, Gs, Gs, Gd, Rb, Gd, Rb, Rb, Gd, Re, Gd^Es, 1 Rb, Gd, Re^Es, Gs, Gs, Gll^Fdf, Gs, Gs, Rb, Ce, Ke, Gll, Gll^Fdf, Gll^Fdf, Gll, Gll^Fmf, Gll, Gll, Gll^Fmf, Gll^Fdf, Gll^Fdf, Gs
Wo, Wo, Wo, Ww, Ww, Ds, Gs, Gs, Gs, Gs, Gs, Gs, Gs, Gs, Gs, Gs, Gll^Fdf, Gs, Gs, Gs, Gd, Rb, Re, Rb, Rb^Ecf, Rb, Re, Gd, Rb, Gd^Esd, Rb, Gd, Rb, Ce, Ce, Re, Gll^Fdf, Gll^Fmf, Gll, Gll^Fdf, Gll^Fdf, Gs, Gll^Fdf, Gll^Fdf, Gll, Gs
Wo, Wo, Wo, Ww, Ww, Ds, Gs, Gs, Gs, Gs, Gll^Fdf, Gll^Fdf, Gll^Fdf, Gll^Fdf, Gll^Fdf, Gll^Fdf, Gs, Gs, Gs, Gs, Gs^Esd, Gs, Gd, 2 Rb, 3 Rb, 4 Rb, Gd, Rb, Gd, Rb, Gd, Rb, Gd, Re^Ecf, Re, Ce, Gll^Fdf, Gll^Fdf, Gll, Gll, Gll, Gll, Gll^Fdf, Gll^Fdf, Gll^Fdf, Gll
Wo, Wo, Wo, Wo, Ww, Ds, Ds, Gs, Gs, Gll^Fdf, Gll^Fdf, Gll^Fdf, Gll^Fdf, Gll^Fdf, Gll^Fmf, Gll^Fmf, Gll, Gd, Gd, Gs, Gd, Gs, Rb, Rb, Gs, Gd, Gs, Gs, Gll^Fdf, Gs, Gs, Gs, Gd, Gd, Gd, Gs, Gs, Gll^Fdf, Gs, Gs, Gs, Gs, Gs, Gll^Fdf, Gll, Gs
Wo, Wo, Wo, Wo, Ww, Ds, Gs, Gs, Gs, Gll^Fdf, Gs, Gll^Fdf, Gll^Fdf, Gs, Gll, Gll^Fdf, Gll^Fdf, Gd, Gd, Gs, Gs, Gs, Re, Gd^Es, Gs, Gs, Gs, Gll^Fdf, Gs, Gs, Gd, Gd, Gd, Gd, Gs, Gs, Gs, Gs, Gs, Gs, Gs, Gs, Gll^Fdf, Gll^Fdf, Gll, Gs
Wo, Wo, Wo, Wo, Ww, Ds, Ds, Gs, Gs, Gs, Gs, Gll^Fdf, Gll^Fdf, Gs, Gs, Gll^Fdf, Gll^Es, Gd, Gs, Gs, Gd, Rb, Ce, Rb, Gd, Gs, Gs, Gs, Gd, Gd, Gs^Es, Gd, Gs, Gs, Gs, Gs, Gs, Gs, Gs, Hh, Hh, Gs, Gll, Gll, Gs, Gs
Wo, Wo, Wo, Wo, Ww, Ww, Ww, Ds, Ds, Gs, Gs, Gs, Gs, Gs, Gs, Gs, Gs, Gd, Gd, Gs, Re, Ce, Ke, Ce, Re^Ecf, Gs, Gs, Gs, Gd, Gs, Gd, Gd, Gs, Gs, Gs, Gs, Gs, Gs, Gs, Hh, Hh, Hh, Gs, Gs, Gs, Gs^Fds
Wo, Wo, Wo, Ww, Ww, Ww, Ww, Ww, Ww, Ww, Ww, Ds, Ds, Gs, Gs, Gs, Gs, Gs, Gd, Gs, Gs, Re, Rb, Ce, Ce, Re, Gs, Gd, Gd, Gs, Gs, Gd, Gll, Gll^Fmf, Gll^Fdf, Gll^Fdf, Gll^Fdf, Gs, Gs, Gs, Gll, Gg^Efm, Gs, Gs, Gs, Gs
Wo, Wo, Wo, Ww, Ww, Ww, Ww, Ww, Ww, Ww, Ww, Ww, Ww, Ds, Ds, Gs, Gs, Gs, Gs, Gd, Gd, Gs, Gs, Gd, Gd, Rb, Gs, Gd, Gd, Gd, Gs, Gs, Gs, Gll, Gll, Gll^Fdf, Gll, Gll^Fdf, Gll, Gll, Gll^Fdf, Gll^Fdf, Gs, Gs, Gs, Gs
Wo, Wo, Wo, Ww, Ww, Ds, Ds, Ds, Gs, Ds, Gs, Ds, Gs, Ww, Ww, Ds, Ds, Gs, Gd, Gs, Gd, Gs, Gd, Gs, Gs, Re, Gs, Gd, Gd, Gd, Gs, Gs, Gll^Fdf, Gll, Gll, Gs, Gll, Gll, Gll^Fmf, Gll^Fmf, Gll^Fdf, Gll, Gs, Gs, Hh, Hh
Wo, Wo, Ww, Ww, Ww, Ds, Gs, Gs, Gs, Gs, Gs, Gs, Gs, Ds, Ww, Ww, Ds, Gs, Gs, Gd, Gd, Gs, Gs, Gd, Gs, Re, Gs, Gs, Gd, Gs, Gs, Gs, Gll^Fmf, Gll^Fmf, Gll^Fdf, Gs, Gll^Fdf, Gll^Fmf, Gll^Fmf, Gll^Fmf, Gll, Gll, Gs, Gs, Gs, Hh
Wo, Wo, Ww, Ww, Ww, Ds, Ds, Gs, Gs, Gs, Gs, Gs, Gs, Ds, Ds, Ds, Gs, Gs, Gs, Gs, Gs, Gd, Gs, Gd, Gd, Gd, Re, Gs, Gd, Gd, Gd, Gs, Gs, Gll^Fdf, Gll, Gll^Fdf, Gll, Gll^Fdf, Gll^Fdf, Gll^Fmf, Gll^Fdf, Gll^Fdf, Gll, Gs, Gs, Hh
Wo, Wo, Ww, Ww, Ww, Ds, Ds, Gs, Gs, Gs, Gll^Fdf, Gll, Gll^Fmf, Gs, Gs, Gs, Gs, Gs, Gs, Gd, Gd, Gd, Gd, Gd, Gd, Gs, Gs, Gd, Gs, Gd, Gd, Gs, Gs, Gs, Gs, Gll, Gs, Gll, Gll, Gll^Fdf, Gll, Gll, Gs, Gs, Gs, Hh
Wo, Wo, Wo, Ww, Ww, Ww, Ds, Gs, Gs, Gs, Gs, Gll^Fdf, Gll^Fdf, Gll^Fmf, Gll^Fmf, Gs, Gll^Fdf, Gs, Gs, Gs, Gs, Gd, Gs, Gd, Gs, Gs, Re, Gs, Gs, Gs, Gs, Gs, Gs, Gs, Gs, Gs, Gs, Gs, Gs, Gs, Gs, Gs, Gs, Gs, Gs, Gs
Wo, Wo, Wo, Ww, Ww, Ww, Ds, Gs, Ds, Gs, Gs, Gll^Fdf, Gll^Fdf, Gll^Fdf, Gll^Fmf, Gll, Gll^Fmf, Gll, Gll, Gll, Gll^Fdf, Gll, Gs, Gd, Gs, Gs, Gs, Re, Gs, Gd, Gs, Gs, Hh, Hh, Hh, Hh^Esd, Gs, Gs, Gs, Gll^Fmf, Gs, Gs, Gs, Gs, Gll^Fdf, Gll^Fdf
Wo, Wo, Wo, Wo, Ww, Ww, Ww, Ds, Ds, Gs, Gs, Gll, Gll, Gll^Fmf, Gll^Fdf, Gll^Fdf, Gll^Fdf, Gll^Fmf, Gll^Fmf, Gll^Fdf, Gd, Gs, Gs, Gs, Gs, Gs, Gs, Gs, Gd, Gs, Gs, Gs, Gs, Hh, Gs, Gs, Gs, Gs, Gll^Fmf, Gll^Fmf, Gll, Gs, Gs, Gs, Gll, Gll^Fdf
Wo, Wo, Wo, Wo, Ww, Ww, Ww, Ww, Ds, Ds, Gs, Gs, Gll^Fmf, Gll^Fmf, Gll^Fmf, Gll^Fmf, Gll^Fmf, Gll^Fdf, Gll^Fdf, Gll^Fdf, Gd, Gd, Gs, Gs, Gs, Gs, Gs, Gs, Gs, Re, Gs, Gs, Gs, Gs, Gs, Gs, Gs^Es, Gs, Gll^Fmf, Gll, Gll^Fmf, Gll^Fmf, Gll^Fdf, Gll, Gll, Gs
Wo, Wo, Wo, Wo, Ds, Ww, Ww, Ww, Ww, Ds, Gs, Gs, Gs, Gll^Fmf, Gll^Fdf, Gll^Fmf, Gll^Fmf, Gll^Fmf, Gll^Fmf, Gd, Gll^Fmf, Gs, Gs, Gs, Gll^Fmf, Gs, Gs, Gs, Gs, Re, Gs, Gs, Gs, Gs, Gll^Fdf, Gll, Gll^Fdf, Gll, Gll^Fdf, Gll^Fmf, Gll^Fdf, Gll^Fdf, Gll^Fdf, Gll^Fdf, Gs, Gs
Wo, Wo, Gs, Gs, Ds, Wo, Wo, Ww, Ww, Gs, Gs, Gs, Gs, Gll^Fmf, Gll^Fmf, Gll^Fdf, Gll^Fmf, Gll^Fmf, Gll^Fmf, Gll^Fmf, Gll^Fmf, Gll^Fmf, Gll^Fmf, Gs, Gs, Gs, Gs, Gs, Gs, Re, Gs, Gs, Gs, Gs, Gs, Gll^Fdf, Gll, Gll^Fdf, Gll, Gll^Fdf, Gll, Gll, Gs, Gll, Gs, Gs
Wo, Wo, Ds, Ds, Wo, Wo, Wo, Ww, Ww, Ww, Ds, Gs, Gs, Gll^Fmf, Gll^Fmf, Gll^Fmf, Gll^Fmf, Gll^Fmf, Gll^Fmf, Gll^Fmf, Gll^Fmf, Gs, Gll^Fmf, Gll^Fmf, Gs, Gs, Gs, Gs, Gs, Gd, Gs, Gs, Gs, Gs, Gd, Gs, Gd, Gs, Gd, Gs, Gs, Gs, Gs, Gs, Gll, Gll^Fdf
Wo, Wo, Wo, Wo, Wo, Wo, Wo, Wo, Wo, Ww, Ww, Ds, Ds, Gs, Gs, Gll^Fmf, Gs, Gll^Fmf, Gll^Fmf, Gll^Fmf, Gll, Gll^Fmf, Gll^Fmf, Gll^Fmf, Gll^Fmf, Gd, Gd, Gs, Gs, Gs, Gd, Gs, Gs, Gd, Gs, Gs, Gd, Gd, Gd, Gd, Gs, Gs, Gs, Gll, Gll^Fdf, Gll^Fdf
Wo, Wo, Wo, Wo, Wo, Wo, Wo, Wo, Wo, Ww, Ww, Ww, Ds, Gs, Gs, Gs, Gll, Gll, Gll^Fdf, Gll^Fdf, Gll^Fdf, Gll^Fdf, Gll^Fdf, Gll^Fmf, Gll^Fmf, Gd, Gs, Gs, Gs, Gs, Gs, Gs, Gs, Gs, Gs, Hh, Hh, Hh, Hh, Hh, Gs, Gll, Gll, Gll^Fdf, Gll^Fdf, Gll^Fdf
