Gs, Gs, Gs, Re, Gs, Gs, Gs, Gs, Gs, Gd, Gd, Gd, Gd, Gs, Gs, Gll^Fp, Gs^Fms, Ww, Ww, Gs^Fp, Gs, Gs^Fp, Gd, Gg, Gs, Gg, Gd, Gg, Gll, Gll^Fdf, Gll^Fdf, Gll^Fdf, Gd, Gs, Gd, Gg, Gs, Gg, Gll^Fdf, Gg, Gll^Fdf, Gs^Fds
Gs, Gs, Gd, Gs, Ce, Gd, Gs, Gs, Gs, Gs, Gs, Gs, Gs, Gd, Gd, Gll^Fp, Gll^Fp, Gs^Fp, Ww, Gll^Fmf, Gs^Vh, Gs^Fp, Gd, Gs, Gs, Gs, Gs, Gll^Fmf, Gll, Gll^Fmf, Gll^Fdf, Gll^Fdf, Gd, Gs, Gd, Gd, Gs, Gll, Gll^Fdf, Gg, Gll^Fdf, Gll^Fdf
Gs, Gs, Ce, 2 Ke, Ce, Gs, Gs, Gs, Hh, Hh, Hh, Hh, Gs^Vh, Gs, Gs, Gd, Gll^Fmf, Gll^Fp, Gll^Fmf, Gs^Fp, Gll^Fmf, Gll^Fmf, Gll^Fmf, Gd, Gs, Gs, Gs, Gs, Gs, Gll, Gs, Gg^Vh, Hh, Gd, Gs, Gs, Gs, Gll, Gll, Gll^Fdf, Gll^Fdf, Gll^Fdf
Gs, Gd, Re, Ce, Gs, Gs, Gs, Gs, Gs, Hh, Gs, Hh, Gs, Gs, Gd, Gs, Gs, Gll^Fp, Gd, Gs^Fp, Gll^Fp, Gd, Gll^Fp, Gll^Fp, Gd, Gs, Gs, Gs, Gs, Gs, Gs, Gs, Hh, Gs, Gs, Gs, Gd, Gs, Gs, Gs, Gll^Fdf, Gll^Fdf
Gs, Gs, Re, Gd, Gs, Gs, Gs, Gs, Gd, Gs, Gs, Gs, Gd, Gs, Gs, Gs, Gs, Gd, Gd, Gd, Gs, Gs, Gs, Gs^Fp, Gs, Gd, Gd, Gd, Gs, Gd, Gd, Hh, Gs, Hh, Hh, Gs, Gll, Gd, Gs, Gs, Gs, Gs
Gs, Gs, Gd, Re, Hh, Hh, Gs, Gd, Gs, Gd, Gd, Gd, Gs, Gs, Gs, Gs, Gs, Gs, Hh, Gs, Gd, Gd, Gd, Gs, Gll^Fmf, Hh, Hh, Gd, Hh, Gs, Gs, Gd, Gs, Hh, Gd, Gd, Gll, Gll^Fdf, Gs, Gs, Gs, Gs
Gs, Gs, Gs^Vh, Re, Gs, Gs, Gs, Gs, Gd, Gd, Gs, Gs, Gs, Gs, Gs, Gs, Gs, Hh, Gs, Hh, Gll, Gd, Gll, Gd, Gll, Gll^Fmf, Gll, Hh, Gs, Hh, Gs, Gs, Gs, Gs, Gs, Gd, Gs, Gll, Gs, Gg^Efm, Gs, Gs
Gs, Gs, Re, Re, Gs, Gs, Gs, Gs, Gd, Gd, Gs, Gs, Gs, Gs, Gll^Fmf, Gs, Gs, Gs, Gll, Gll, Gll^Fdf, Gll^Fmf, Gll^Fdf, Gll^Fdf, Gll^Fdf, Gll^Fdf, Gll^Fdf, Gll^Fdf, Gll^Fdf, Gll^Fdf, Gs, Gs, Gs, Gs, Gd, Gd, Gs, Gs, Gs, Gs, Gs, Gs
Gs, Gs, Re, Gs, Gs, Gs, Gs, Gs, Gs, Gs, Gs, Gs, Gll^Fdf, Gll^Fdf, Gll^Fdf, Gll^Fdf, Gs, Gs, Gll^Fdf, Gll^Fdf, Gll^Fdf, Gll^Fdf, Gll^Fdf, Gll^Fdf, Gll^Fdf, Gll^Fdf, Gll^Fdf, Gll^Fdf, Gs, Gs, Gs, Gs, Gs, Gd, Gs, Gd, Gs, Gs, Gd^Vh, Gs, Gs, Gs
Gs, Gs, Gs, Re, Re, Gs, Gs, Gd, Gs, Gs, Gll, Gll, Gll^Fdf, Gll^Fdf, Gs^Vl, Gs, Gs, Gs, Gs, Gll^Fdf, Gll, Gll, Gs, Gs^Vc, Gll^Fdf, Gll^Fdf, Gll, Gll, Gs, Gs, Gs, Gs, Gs, Gs, Hh, Gs, Gs, Gs, Gs, Gs, Gs, Gs
Gs, Gd, Gs, Gs, Re, Gs, Gs, Gd, Gs, Gs, Gll, Gll^Fdf, Gll^Fdf, Gll^Fdf, Gs, Gs, Re^Gvs, Re^Gvs, Re^Gvs, Gs, Gs, Gs, Re, Gll, Gll^Fdf, Gll^Fdf, Gll^Fdf, Gll, Gll, Gs, Gd, Gd, Hh, Hh, Gg^Vh, Hh, Gd, Gd, Hh, Hh, Gs, Gs
Gs, Gd, Gd, Gs, Gs, Re, Gs, Gd, Gs, Gs, Gll, Gll^Fdf, Gll^Fdf, Gll^Fdf, Gs, Gs, Re^Gvs, Re^Gvs, Gs, Gd^Vh, Re, Gs, Gs, Gll^Fdf, Re^Gvs, Gll^Fdf, Gd^Vh, Gll^Fdf, Gll^Fdf, Gs, Gs, Gd, Gs, Hh, Hh, Gs, Hh, Gd, Gs, Hh, Gs, Gs
Gs, Gs, Gd, Gs, Gs, Re, Re, Gd, Gs, Gs, Gll, Gll^Fdf, Gll, Gs^Vl, Rd, Gs, Gs, Gs, Re, Re, Gs, Re, Gs, Gs, Re^Gvs, Re^Gvs, Re^Gvs, Gs, Gll^Fdf, Gs, Gs, Gd, Gs, Gs, Gs, Gs, Gs, Gd, Gd, Hh, Gs, Gs
Gs, Gs, Gs, Gd, Gd, Gs, Re, Gs, Gs, Gd, Gd, Gs, Gs, Gs, Gs, Re, Re, Gs, Re, Gs, Ch, Gs, Rp, Gs, Gs, Re^Gvs, Gs, Gs, Gs, Gs, Gs, Gd, Gd, Gs, Gs, Gll, Gll^Fdf, Gs, Gd, Gs, Gs, Gs
Hh, Hh, Hh, Gs, Gs, Gs, Re, Gs, Gs, Gd, Gs, Gs, Gs, Gs, Re, Re, Gs, Re, Rr, Ch, 1 Kh, Ch, Rr, Re, Re, Gs, Re, Re, Re, Gs, Gs, Gs, Gs, Gd, Gs, Gll^Fdf, Gll, Gll^Fdf, Gll, Gs, Gs, Gs
Hh, Hh, Hh, Gs, Gs, Gs, Gs, Rb, Rb, Gs, Re, Re, Re, Re, Gs, Gs, Gd, Ch, Rr^Vhc, Rrc, Rrc, Rrc, Rr^Vhc, Re, Gd, Re, Gs, Gs, Gs, Re, Re, Re, Re, Gs, Gs, Gs, Gs, Gll^Fdf, Gll, Gs, Gs, Gs
Gs, Gs, Gs, Gs, Gs, Gs, Gs, Gd^Vh, Rb, Gs, Gs, Gd, Gs, Re, Rd, Gs, Gs, Ch, Rr, Rrc, Rr, Rrc, Re, Ch, Gs, Gs, Gd, Gd, Gs, Gs, Gs, Gs, Gs, Re, Re, Gd, Gd, Gd, Gs, Gs, Gs, Gs
Gs, Gd, Gd, Gs, Re, Gs, Re, Re, Gs, Gs, Gll^Fdf, Gs, Gs, Gs, Gs, Re, Re, Re, Re, Ch, Rp, Ch, Re, Gd, Gd, Gd, Gs, Gs, Gd, Gd, Gd, Gs, Gs, Gs, Gs, Re, Re, Gd^Vh, Hh, Gs, Gs, Gs
Gs, Gd, Re, Re, Gs, Re, Gs, Gs, Gd, Gs, Gs, Gll, Gs, Gll^Fdf, Gd^Vh, Rd, Gs, Gs, Gs, Gs, Gd, Gs, Gs, Re, Gs, Gs, Re^Gvs, Gll, Gd, Gd, Gs, Gd, Gs, Gs, Gd, Gs, Re, Gs, Gs, Hh, Hh, Hh
Re, Re, Gs, Gs, Gs, Gd, Gd, Gs, Gs, Gd, Gd, Gs, Gs, Gll^Fdf, Gs, Gs, Gd, Gs, Gs, Gd, Gs, Gs, Re^Gvs, Re^Gvs, Re^Gvs, Re^Gvs, Re^Gvs, Gll^Fdf, Gs^Vh, Gd, Gs, Gll, Gll, Gs, Gd, Gs, Gs, Re, Re, Gll^Fdf, Gll^Fdf, Gll^Fdf
Gs, Gs, Gd, Gs, Gd, Gd, Gs, Gd, Gll^Fdf, Gll, Gll^Fdf, Gd, Gd, Gd, Gd, Gd, Gd, Gll, Gll^Fdf, Gd^Vh, Gll, Gs, Gs, Re^Gvs, Re^Gvs, Re^Gvs, Gs, Gll, Gs, Gd, Gs, Gll^Fdf, Gs, Gd, Gs, Gll, Gll^Fdf, Gs, Re, Gs, Gs, Gll^Fdf
Gs, Gd, Gd, Gs, Gd, Gll, Gll, Gll^Fdf, Gll, Gll^Fdf, Gll^Vh, Gll^Fdf, Gll, Gd, Gs, Gd, Gd, Gs, Gll^Fdf, Gll^Fdf, Gll^Fdf, Gll^Fdf, Gll^Fdf, Gll^Fdf, Gs, Gs, Gll, Gll, Gll^Fdf, Gd, Gd, Gll, Gd, Gd, Gs, Hh, Gll^Fdf, Gll, Gs, Re, Gs, Gd
Gs, Gs, Gd, Gd, Gs, Gll^Fdf, Gll, Gll, Gll^Fdf, Gll, Gll^Fdf, Gll^Fdf, Gll^Fdf, Gll, Gs, Gd, Gd, Gll, Gll^Fdf, Gll^Fdf, Gll^Fdf, Gll^Fdf, Gll, Gll, Gs, Gll, Gll^Fdf, Gll^Fdf, Gll^Fdf, Gll, Gs, Gd, Gd, Gd, Gs, Hh, Hh, Gll^Fdf, Gs, Re, 3 Gs, Gs
Gs, Gs, Gs, Gll, Gll, Gll^Fdf, Gll^Fdf, Gll, Gll^Fdf, Gll, Gll^Fdf, Gll^Fdf, Gll^Fdf, Gll^Fdf, Gs, Gd, Gs, Gll, Gs, Gll, Gs, Gll, Gs, Gs, Gd^Vh, Gll, Gll, Gll, Gs, Gll, Gs, Gs, Gs, Gd, Gs, Gd, Gs, Gll, Gs, Re, Gs, Gs
Gs, Gs, Gs, Gs, Gs, Gll, Gs, Gs, Gs, Gll^Fmf, Gs, Gll, Gll^Fmf, Gs, Gs, Gs, Gs, Gs, Gs, Gs, Gs, Gs, Gll^Fdf, Gs, Gll^Fdf, Gs, Gs, Gs, Gs, Gs, Gs, Gs, Gd^Vh, Gs, Gs, Gs, Gs, Gs, Gd, Gd, Gs, Re
Gs, Gs, Gs, Gs, Hh, Hh, Gs, Gs, Gs, Gs, Gs, Gll, Gll^Fmf, Gs, Gs, Gd^Vh, Gs, Gs, Gs, Gs, Gs, Gs, Gs, Gll^Fdf, Gll^Fdf, Gll^Fdf, Gll, Gs, Gs, Gs, Gs, Gs, Gs, Gs, Gs, Gs, Gs, Gs, Gd, Gs, Gs, Gs
Gs, Gs, Gs, Gs, Gs, Hh, Gs, Gs, Gs, Gs, Gs, Gs, Gs, Gs, Gs, Gs, Gs, Gs, Gs, Gs, Gs, Gd, Gd, Gll, Gll, Gll^Fdf, Gll, Gll, Gs, Gs, Gs, Gs, Gs, Gs, Gs, Gs, Gll^Fdf, Gs, Gs, Gd, Gs, Gs
Gs, Gs, Gs, Gd, Gs, Gs, Gs, Gs, Gs, Gs, Gs, Gs, Gs, Gs, Gd, Gs, Gd, Gs, Gs, Gs, Gs, Gs, Gs, Gd, Gs, Gll, Gs, Gll, Gs, Gs, Gs, Gs, Gs, Gs, Gll^Fdf, Gll^Fdf, Gll, Gs, Gs, Gs, Gs, Gs
Gs, Gs, Gs, Gd, Gd, Gs, Gs, Gd^Vh, Gs, Gs, Hh, Hh, Gs, Gd, Gs, Gd, Gs, Gd, Gs, Gs, Gs, Gs, Gs, Gs, Gs, Gs, Gs, Gs, Gs, Gs, Gs, Gs, Gs, Gs, Gll^Fdf, Gll, Gs, Gs, Gd, Gs, Gs, Gs
Gs, Gs, Gs, Gs, Gs, Gd, Gs, Gs, Gs, Gll^Fdf, Hh, Hh, Gs, Gs, Gs, Gs, Gs, Gs, Gs, Gll^Fdf, Gll^Fdf, Gs, Gs, Gs, Gd^Vh, Gs, Gs, Gs, Gs, Gs, Gs, Gs, Gs, Gs, Gs, Gs, Gd, Gd, Gs, Gs, Gd, Gs
Re, Gs, Re, Gs, Gd, Gd, Gs, Gs, Gs, Gll^Fdf, Gll^Fdf, Hh, Hh, Gs, Gd^Vh, Gs, Gs, Gs, Gs, Gll, Gll^Fdf, Gll^Fdf, Gll, Gll^Fdf, Gs, Gs, Gs, Gs, Gs, Gs, Gd, Gs, Gs, Gs, Gs, Gs, Gd, Gd, Gd, Gs, Gd, Gs
Gll^Fdf, Re, Gs, Re, Gs, Gd, Gd, Gs, Gll^Fdf, Gll^Fdf, Gll^Fdf, Hh, Gs, Gs, Gs, Gs, Gs, Gs, Gs, Gs, Gll^Fdf, Gll^Fdf, Gll^Fdf, Gll^Fdf, Gs, Gs, Gs, Gs, Gs, Gs, Gs, Gs, Gs, Gs, Gs, Gs, Gd, Gs, Gd^Vh, Gd, Gs, Gs
Gll^Fdf, Gll^Fdf, Gll, 4 Gs, Gs, Gs, Gd, Gs, Gs, Gs, Gll^Fdf, Gll^Fdf, Gs, Gs, Gs, Gs, Gd, Gd, Gd, Gs, Gs, Gll, Gll^Fdf, Gll^Fdf, Gll^Fdf, Hh, Gs, Gs, Gs, Gs, Gs, Gs, Gs, Gs, Gs, Gs, Gd, Gd, Gd, Gd, Gs, Gs
Gll^Fdf, Gll^Fdf, Gll, Gd, Gs, Gs, Gs, Gs, Gs, Gs, Gs, Gs, Gs, Gs, Gs, Gd, Gs, Gd, Gd, Gs, Gs, Gs, Gs, Gll, Gs, Hh, Gs, Gs, Gs, Gs, Gll^Fdf, Gll^Fdf, Gll^Fdf, Gs, Gs, Gs, Gs, Gd, Gd, Gd, Gs, Gs
Gll^Fdf, Gll^Fdf, Gll, Gs, Gs, Gd, Gs, Gs, Gll^Fdf, Gs, Gll^Fdf, Gs, Gs, Gs, Gs, Gs, Gs, Gs, Gs, Gd, Gs, Gs, Gs, Gs, Gs, Gs, Gs, Gs, Gs, Gll^Fdf, Gll^Fdf, Gll^Fdf, Gll^Fdf, Gs, Gs, Gs, Gs, Gd, Gd, Gs, Gs, Gs
Gll^Fdf, Gll^Fdf, Gs, Gs, Gs, Gs, Gll^Fdf, Gll^Fdf, Gll^Fdf, Gll^Fdf, Hh, Gll^Fdf, Gll^Fdf, Gs, Gs, Gs, Gs, Gs, Gs, Gd, Gd, Gd, Gd, Gs, Gs, Gs, Gs, Gs, Gs, Gll^Fdf, Gll, Gll, Gll^Fdf, Gll^Fdf, Gs, Gs, Gs, Gd, Gs, Gs, Gs, Gs
Gll, Gs, Gs, Gs, Gg^Vh, Gll^Fdf, Hh^Fdf, Hh^Fdf, Gll^Fdf, Gll^Fdf, Hh, Gll^Fdf, Gll^Fdf, Gs, Gll^Fdf, Gs, Gll^Fdf, Gs, Gs, Gs, Gs, Gs, Gs, Gd, Gs, Gs, Gs, Gs, Gs, Gll^Fdf, Gll^Vh, Gll, Gll^Fdf, Gs, Gs, Gs, Gs, Gs, Gs, Gs, Gll^Fdf, Gs^Fms
Gs, Gs, Gs, Gs, Gll^Fdf, Hh, Hh^Fdf, Hh^Fdf, Hh, Gll, Gll^Fdf, Hh, Gll^Fdf, Gll^Fdf, Gll^Fdf, Gll^Fdf, Gll^Fdf, Gs, Gll^Fdf, Gll^Fdf, Gll^Fdf, Gs, Gs, Gd, Gd, Gd, Gs, Gs, Gs, Gll^Fdf, Gll^Fdf, Gll^Fdf, Gs, Gs, Gd, Gd, Gs, Gs, Gll, Gll^Fdf, Gll^Fdf, Gs^Fms
Hh, Hh, Hh^Fdf, Gll^Fdf, Hh^Fdf, Gll^Fdf, Gll^Fdf, Hh, Gll^Fdf, Gll^Fdf, Hh, Gll^Fdf, Gll^Fdf, Gll^Fdf, Gll^Fdf, Gll, Gll, Gll^Fdf, Gll^Fdf, Gll^Fdf, Gll, Gll^Fdf, Gs, Gs, Gs, Gs, Gs, Gs, Gs, Gs, Gs, Gs, Gs, Gs, Gs, Gs, Gs, Gll, Gll^Fdf, Gll^Fmf, Gg, Gg
Gll^Fdf, Hh^Fdf, Hh^Fdf, Hh, Hh^Fdf, Hh^Fdf, Gll^Fdf, Gll^Fdf, Hh^Fdf, Hh^Fdf, Hh^Fdf, Gll^Fdf, Gll, Gll^Fdf, Gll^Fdf, Gll^Fdf, Gll^Fdf, Gll^Fdf, Gll^Fdf, Gll, Gll^Fdf, Gll^Vh, Gs, Gll^Fdf, Gll^Fdf, Gs, Gs, Gs, Gll, Gll, Gll, Gs, Gll^Fdf, Gll^Fdf, Gs, Gll^Fmf, Gll^Fmf, Gll, Gll^Fmf, Gll^Fmf, Gll^Fdf, Gll^Fdf
Gll^Fdf, Gll^Fdf, Hh^Fdf, Hh^Fdf, Hh^Fdf, Hh, Hh, Hh^Fdf, Hh^Fdf, Hh^Fdf, Hh^Fdf, Gll, Gll^Fdf, Gll^Fdf, Gll^Fdf, Gll, Gll^Fdf, Gll^Fdf, Gll^Fdf, Gll^Fdf, Gll^Fdf, Gll^Fdf, Gs, Gll^Fdf, Gs, Gs, Gs, Gs, Gs, Gs, Gs, Gll^Fdf, Gll, Gs, Gs, Gs, Gll^Fdf, Gll^Fmf, Gll^Fdf, Gll^Fmf, Gll^Fmf, Gll^Fdf
Gll^Fdf, Gll^Fdf, Gll^Fdf, Hh, Gs^Fds, Hh, Hh, Hh^Fdf, Hh^Fdf, Hh^Fdf, Hh^Fdf, Gll^Fdf, Gll^Fdf, Gll^Fdf, Gll^Fdf, Gll^Fdf, Gll^Fdf, Gll^Fdf, Gll^Fdf, Gll^Fdf, Gll^Fdf, Gll^Fdf, Re, Gll^Fdf, Gll^Fdf, Gs, Gs, Gs, Gs, Gs, Gs, Gs, Gs, Gs, Gs, Gs, Gll^Fdf, Gll^Fdf, Gll^Fmf, Gll^Fmf, Gll^Fmf, Gll^Fdf
