Gll^Fp, Gll^Fp, Gll^Fp, Gll^Fp, Gll^Fp, Gs, Gll^Fp, Gg, Gll^Fmw, Gg, Gll^Fp, Gg, Gll^Fp, Gg, Gll^Fp, Gll^Fp, Gll^Fp, Gll^Fp, Gd^Vo, Gg, Gll^Fp, Gll^Fp, Gll^Fp, Gll^Fp, Gll^Fp, Gll^Fp, Gll^Fp, Gg, Gs, Re, Gg^Es, Gs, Gll^Fp, Gg, Gll^Fp, Gg, Hh, Mm, Mm, Mm, Mm, Mm
Gll^Fp, Gll^Fp, Gll^Fmw, Gll^Fp, Gll^Fp, Gs^Es, Gll^Fp, Gll^Fp, Gll^Fmw, Gll^Fp, Gll^Fp, Gll^Fp, Gll^Fp, Gll^Fp, Gll^Fp, Gll^Fp, Gs, Gll^Fp, Gll^Fp, Gll^Fmw, Gll^Fp, Gll^Fp, Gll^Fp, Gll^Fp, Gll^Fp, Gll^Fp, Gll^Fp, Gll^Fp, Gs, Re, Gs^Es, Gs, Gll^Fp, Gll^Fp, Gll^Fp, Hh, Hh, Mm, Mm, Mm, Mm, Mm
Gll^Fp, Gll^Fmw, Gll^Fp, Gs, Gll^Es, Gll^Fp, Gll, Gll^Fp, Gll^Fp, Gs, Gd^Vo, Gll^Fp, Gll, Gll^Fmw, Hhd, Gll^Fp, Hhd, Gll^Fp, Gll, Gll^Fp, Gll^Fp, Gll^Fp, Gll^Fmw, Gll^Fmw, Gll^Fmw, Gll^Fmw, Gll^Fp, Gll^Fp, Gll^Fp, Re, Re, Gs^Es, Gll^Fp, Gll^Fp, Gll^Fp, Hh, Hh, Mm, Mm, Mm, Mm, Mm
Gg, Gll^Fp, Gll^Fp, Gll^Fp, Gll^Fp, Gll^Fp, Gll^Fp, Gll^Fp, Gll^Fp, Gll^Fmw, Gll^Fp, Gll^Fp, Gll^Fp, Gll^Fmw, Gll^Fp, Hhd, Gll^Fp, Hhd, Hhd, Hhd, Hhd, Gll^Fp, Hhd, Gs^Es, Hhd, Gll^Fp, Gll^Fp, Gll^Fp, Gll^Fp, Re, Gs, Gll^Fp, Gll^Fp, Gll^Fp, Gll^Fp, Hh, Hh, Mm, Mm, Mm, Mm, Mm
Gll^Fp, Gll^Fp, Gll^Fp, Gll^Fp, Gll^Fp, Gll^Fp, Gll^Fp, Gs^Fp, Gll^Fp, Gs^Fp, Gll^Fp, Gll^Fp, Gs^Fp, Gll^Fp, Gll^Fp, Gll^Fp, Gll^Fp, Gll^Fp, Hhd, Hhd, Gll^Fp, Hhd, Hhd, Gll^Fp, Hhd, Rb, Gll^Fp, Gll^Fmw, Gll^Fp, Re, Re, Gll^Fp, Gll^Fp, Gd, Gll^Fp, Gd, Gll^Fp, Mm, Mm, Mm, Mm, Mm
Gs^Fp, Gll^Fmw, Gs^Fp, Gll^Fp, Gll^Fmw, Gll^Fp, Gll^Fp, Gll^Fp, Gll^Fmw, Gll^Fp, Gll^Fp, Gll^Fmw, Gll^Fp, Gll^Fp, Gll^Fp, Gll^Fmw, Gll^Fp, Gll^Fp, Gll^Fp, Gll^Fp, Hhd, Gll^Fp, Gll^Fmw, Hhd, Gll^Fp, Gll^Fp, Gll^Fp, Gll^Fmw, Gll^Fp, Gs, Re, Gs, Gll^Fp, Gll^Fp, Gll^Fp, Gll^Fp, Gll^Fmw, Gll^Fp, Mm, Mm, Mm, Mm
Gll^Fp, Gll^Fp, Gll, Gll^Fp, Rb^Es, Gll^Fp, Gll^Fp, Gll^Fmw, Gll^Fp, Gll^Fp, Gll^Fp, Gll^Fp, Hhd^Vo, Gll^Fp, Gll^Fmw, Gll^Fp, Gll^Fp, Gs^Fp, Gll^Es, Gll^Fp, Hhd, Gd^Vo, Hhd, Hhd, Hhd^Es, Hhd, Hhd, Gll^Fp, Gs^Em, Gll^Fmw, Re, Gs, Gll^Fmw, Gll^Fp, Hh, Hh, Gll^Fp, Hh, Mm, Mm, Mm, Mm
Re, Rb^Es, Hhd, Rb, Hhd^Vo, Rb, Rb, Gll^Fmw, Rb^Es, Hhd, Hhd, Hhd, Hhd, Hhd, Gll^Fp, Gll^Fmw, Gll^Fp, Gll^Fp, Hhd^Es, Hhd, Hhd, Hhd^Es, Hhd, Hhd, Gll^Fp, Gll^Fp, Gll^Fp, Gll^Fp, Gll^Fp, Gs, Gll^Fmw, Gll^Fp, Gll^Fp, Gll^Fp, Hh, Hh, Gll^Fp, Hh^Es, Mm, Mm, Mm, Mm
Re^Es, Hhd, Mm, Hhd, Rb^Es, Rb^Es, Co, Rb^Es, Hhd, Mm, Mm, Mm, Mm, Hhd^Es, Gs^Fp, Gs^Fp, Gll^Fp, Hhd, Hhd, Hhd, Gll^Fp, Hhd, Gs^Es, Hhd, Gll^Fmw, Gll^Fp, Gd^Vo, Gll^Fp, Gll^Fmw, Re, Gs^Es, Gll^Fp, Gll^Fp, Hh^Es, Hh, Gs, Gll^Fp, Hh, Mm, Mm, Mm, Mm
Hhd, Mm, Mm, Hhd, Mm, Co, 2 Ket, Co, Mm, Mm, Hhd, Hhd, Mm, Hhd, Gll^Fmw, Gll^Fet, Gll^Fp, Gll^Fp, Gll^Fp, Gll^Fp, Gs, Gll^Fp, Gll^Fp, Hhd, Gll^Fp, Gll^Fp, Gs^Es, Gll^Fp, Re, Gs, Gll^Fp, Gll^Fp, Gll^Fp, Gll^Fp, Gll^Fp, Gll^Fp, Hh^Es, Hh, Hh, Mm, Mm, Mm
Re, Hhd, Hhd, Mm, Mm, Co, Ce, Ce, Mm, Hhd^Vo, Hhd, Re^Es, Re, Hhd, Hhd, Gll^Fp, Gll^Fmw, Gll^Fp, Gs^Em, Gll^Fmw, Gll^Fp, Gll^Fp, Re^Es, Gll^Fmw, Re, Gll^Fp, Re, Re, Gll^Fp, Gll^Fp, Gll^Fp, Gll^Fp, Gll^Fp, Gll^Fp, Re, Gll^Fp, Hh, Hh, Mm, Mm, Mm, Mm
Gll^Fmw, Re^Es, Re, Mm, Mm, Mm^Vc, Mm, Mm, Mm, Mm, Mm, Hhd, Re, Hhd, Re^Es, Gll^Fp, Gll^Fp, Gll^Fp, Gll^Fp, Gll^Fp, Re, Re, Re, Re, Re^Es, Re, Gs, Gs, Gs, Gll^Fp, Gd^Fetd, Gll^Fp, Gs, Gll, Gll^Ecf, Re, Gd^Vo, Hh, Mm, Mm, Mm, Mm
Gll^Fp, Gll^Fdw, Re, Hhd, Mm, Mm, Hhd, Mm, Hhd, Hhd, Hhd, Mm, Hhd, Re^Es, Re, Re, Re, Re, Re, Re, Gll^Fp, Gs, Gll^Fp, Gll^Fp, Gll^Fmw, Re, Gs, Gll^Fp, Gll^Fp, Gll^Es, Gll^Fp, Gll, Hh^Es, Hh, Gll^Fp, Gll^Fp, Hh^Es, Hh, Mm, Mm, Mm, Mm
Re^Es, Re, Hhd, Mm, Hhd, Mm, Mm, Re^Es, Re, Hhd, Re^Es, Hhd, Hhd, Re, Gll^Fmw, Gll^Fp, Gll^Fp, Gll^Fp, Gll^Fp, Gll^Fp, Gll^Fp, Gll^Fp, Gll^Fp, Gll^Fp, Gll^Fp, Re, Re, Gll^Fp, Gll^Fmw, Gll^Fp, Gll^Fp, Hh, Hh, Hh, Gll^Fp, Hh, Hh, Hh, Mm, Mm, Mm, Mm
Re, Re, Hhd, Mm, Re, Hhd, Hhd, Mm, Hhd, Re, Hhd^Vo, Re, Gd^Fp, Re, Re^Es, Gs^Fp, Gs^Fp, Gs^Fp, Gd^Em, Gll^Fp, Gll^Fp, Gll^Fp, Gll^Fmw, Gll^Fp, Gll^Fp, Gll^Fp, Gll^Fp, Gs, Gll^Fp, Gll^Fp, Hh, Hh, Gll^Fp, Gll^Fp, Hh, Gll^Fp, Gll^Fp, Hh, Mm, Mm, Mm, Mm
Re^Es, Re, Hhd, Hhd, Re^Es, Re, Re, Hhd, Gd^Fp, Hhd, Gd^Fp, Gd^Fp, Re^Es, Re, Re, Gd^Fp, Gd^Fet, Gs^Fp, Gll^Fp, Gll^Fmw, Gll^Fp, Gll^Fp, Gll^Fp, Gd^Vo, Gs^Es, Gll^Fmw, Gs, Gs, Gs, Gll^Fmw, Gll^Fp, Gll^Fp, Gs, Gs^Em, Hh, Gll^Fp, Hh, Hh, Hh, Mm, Mm, Mm
Gs^Fp, Gd^Fp, Gd^Fp, Hhd, Re, Gd^Fp, Gd^Vc, Re, Re, Gd^Fmw, Gd^Fp, Gs^Fmw, Re^Edb, Re^Es, Re, Gs^Fp, Gs^Fp, Gs^Fp, Gs^Es, Gll^Fp, Gll^Fp, Gll^Fp, Gll^Fp, Gs, Gs, Gg, Re^Es, Gg, Gll^Fp, Gll^Fp, Gs, Gll^Fp, Gs, Gll^Fp, Hh, Hh, Hh^Es, Hh, Hh, Hh, Mm, Mm
Gd^Fp, Re, Re, Re, Re, Gd^Fp, Gd^Fp, Gd^Fp, Re, Gs^Fp, Re, Gs^Fp, Gs^Fp, Re, Gs^Es, Gs^Fp, Gs^Fp, Gs^Fp, Gg, Gs, Gll^Fp, Gll^Fp, Gll^Fp, Gll^Fp, Gll^Fp, Re, Gs, Gll^Fp, Gll^Fp, Gll^Fmw, Gs, Gs, Gll^Fp, Gll^Fp, Hh, Hh, Hh, Hh^Es, Hh, Mm, Mm, Mm
Gs^Fp, Re, Re, Re, Gs^Fp, Gs^Fp, Gs^Fp, Re, Re, Gs^Fp, Gs^Fp, Gs^Fmw, Gs^Fp, Re, Gs^Vc, Gll^Fp, Gll^Fp, Gs^Fp, Gll^Fmw, Gs, Gll^Fp, Gll^Fp, Gll^Fp, Gll^Fp, Gll^Fp, Gg, Gg, Gll^Fp, Gll^Fp, Gs^Es, Gll^Fmw, Gll^Fp, Gll^Fp, Gll^Fp, Gll^Fp, Gll^Fmw, Hh, Hh, Hh, Mm, Mm, Mm
Gs^Fmw, Gs^Fp, Gs^Vo, Re, Gs^Fp, Gg^Fet, Gs^Fp, Re, Gs^Fp, Gs^Fp, Gll^Fmw, Gs^Fp, Gs^Fp, Re, Re, Gll^Fp, Gll^Fp, Gll^Fp, Gll^Fp, Gg, Gs, Gll^Fp, Gll^Fp, Gll^Fp, Gg, Gg, Gll^Fmw, Gd^Vo, Gll^Fp, Gll^Fp, Hh, Gll^Fp, Gd^Fetd, Gll^Fp, Gll^Fp, Gll^Fmw, Hh^Es, Hh, Hh, Mm, Mm, Mm
Gs^Fp, Gs^Fp, Gs^Fp, Re, Gs^Fp, Gs^Fmw, Gs^Fp, Gs^Fp, Gs^Fp, Gs^Fp, Gs^Fp, Gs^Fp, Gs^Fp, Gs^Fp, Gs^Fp, Re, Re, Gs, Gs, Gll^Fp, Gs, Gs, Gg, Gg, Gll^Fp, Gg, Gs, Gll^Fp, Gll^Fp, Gll^Fmw, Hh, Gll^Fp, Gll^Fp, Gs^Es, Hh, Hh, Hh, Hh, Mm, Mm, Mm, Mm
Gs^Fp, Gs^Fp, Re, Re, Gs^Fp, Gs^Fp, Gs^Fp, Gs^Fp, Gs^Fp, Gg^Vc, Gg, Gs^Fp, Gs^Fp, Gg^Fet, Gs^Fp, Gs, Gs, Re, Re^Es, Gs, Gll^Fp, Gll^Fp, Gll^Fp, Gll^Fp, Gll^Fp, Gs, Gs, Gll^Fp, Gll^Fp, Hh, Gll^Fp, Gll^Fp, Gs, Gs, Hh, Hh, Hh, Hh, Mm, Mm, Mm, Mm
Gs^Fp, Gs^Fp, Re, Gs^Fp, Gs^Fp, Gs^Fp, Gs^Fp, Gs^Fp, Gs^Fp, Gg, Gs, Gs, Gll^Fp, Gs^Fp, Gs^Fp, Gs^Fp, Gs^Fp, Gs, Re, Gs, Gs, Gll^Fmw, Gs, Gll^Fp, Gll^Fp, Gll^Fp, Gll^Fp, Gs, Gs^Es, Gll^Fmw, Gll^Fp, Gs, Gg, Gg, Hh, Hh^Es, Hh, Mm, Mm, Mm, Mm, Mm
Gs^Fp, Gs^Fp, Re, Gs^Fp, Gs^Fp, Gs^Fp, Gg^Fet, Gs^Fp, Gs^Fp, Gs, Gs, Gs, Gg, Gg, Gg, Gg^Vc, Gs^Fp, Gs, Gs, Re, Gs, Gs, Gs, Gs, Gs, Gll^Fp, Gll^Fp, Gll^Fp, Gll^Fp, Gll^Fmw, Gll^Fp, Gs, Hh, Hh, Hh^Es, Hh, Hh, Mm, Mm, Mm, Mm, Mm
Gs^Fp, Gs^Vc, Gs^Fp, Re, Re, Gs^Fp, Gs^Fp, Gs^Fp, Gs^Fp, Gs^Fp, Gs, Gs, Gs^Fp, Gs^Fp, Gg, Gs^Fp, Gs^Fp, Gs^Fp, Gs, Re, Re, Gs, Gs, Gg, Gs, Gll^Fp, Gll^Fp, Hh, Gll^Fmw, Gll^Fp, Gll^Fp, Gs, Hh, Hh, Hh, Hh, Hh, Mm, Mm, Mm, Mm, Mm
Gs^Fp, Gg, Gs^Fp, Re, Re, Gs^Fp, Gs^Fp, Gs^Fp, Gs^Fp, Gs, Gs^Fp, Gs^Fp, Gs^Fp, Gs^Fp, Gg, Gs^Fp, Gs^Fp, Gs^Fp, Gg, Gs, 1 Ke, Ce, Gd, Gg, Gg^Efm, Gs, Gll^Fp, Hh, Hh, Gs^Vc, Gll^Fp, Gg, Gs, Hh, Hh, Hh, Hh^Es, Hh, Mm, Mm, Mm, Mm
Gs^Fp, Gg, Gll^Fmw, Gll^Fmw, Re, Re, Gs^Fp, Gs^Fp, Gs^Fp, Gs, Gs^Fp, Gs^Fp, Gs^Fp, Gs^Fp, Gg, Gs^Fp, Gs^Fp, Gs, Gg, Gg, Ce, Ce, Re, Gs, Gg, Gg, Gs, Gll^Fp, Gll^Fp, Hh, Gd^Em, Gg, Gg, Hh, Hh^Es, Hh, Hh, Hh, Mm, Mm, Mm, Mm
Gs^Fp, Gs^Fp, Gs^Fp, Gs^Fp, Gs^Fp, Re, Re, Gll^Fmw, Gs, Gs, Gs^Fp, Gs^Fp, Gs^Fp, Gs^Fp, Gs^Fp, Gs^Fp, Gs, Gs^Fp, Gd, Ce, Gd, Ce, Re, Gs, Gs, Gs, Gg, Gs, Hh, Hh, Gll^Fmw, Gg, Gg, Hh, Hh, Hh, Hh, Hh, Mm, Mm, Mm, Mm
Gs^Fp, Gs^Fp, Gs^Fp, Gs^Fp, Gs^Fp, Re, Re, Gs, Gs^Fp, Gs^Fmw, Gs^Fp, Gs^Fp, Gd, Gs^Fp, Gs^Fp, Gs^Fp, Gs, Gs, Gs^Fp, Gg, Gg, Gs, Gg, Re, Re, Gs, Gg, Gs, Gs^Es, Hh, Hh, Gg, Gg, Gs, Gs^Es, Hh, Hh, Mm, Mm, Mm, Mm, Mm
Gs^Fp, Gs^Fmw, Gs^Fp, Gs^Fp, Gs^Fp, Gs^Fp, Re, Gs, Gs^Fp, Gs^Fp, Gs^Fp, Gs^Fp, Gs^Fp, Gg^Vc, Gg, Gs^Fp, Gs, Gs, Gs^Fp, Gs^Fp, Gs, Gg, Gs, Gs^Es, Re, Re, Re, Gs, Gll^Fp, Hh, Hh, Hh, Gs, Gg, Gs, Hh, Hh^Es, Mm, Mm, Mm, Mm, Mm
Gs, Gs^Fp, Gs, Gd, Gd, Gs^Fp, Re, Gs^Fp, Gs^Fp, Gs^Fp, Gll^Fmw, Gs^Fp, Gs^Fp, Gs, Gg, Gs, Gs, Gs^Fp, Gs^Fp, Gs^Fp, Gs^Fp, Gs, Gs^Esd, Gs, Re, Gs, Re, Gs, Gs, Gll^Fp, Gll^Fp, Gll^Fp, Gs, Gs, Gs, Hh, Hh, Hh, Hh, Mm, Mm, Mm
Gs, Gd, Gs^Fmw, Gg, Gs^Fp, Gs^Fp, Re, Gs^Fp, Gs^Fp, Gs^Fp, Gs, Gs, Gs, Gs, Gs, Gs, Gs, Gs, Gs, Gg^Vc, Gs^Fp, Gs, Gs, Re, Gs, Gs, Re, Gg^Efm, Gg, Gs, Gs, Gs, Gs, Gs^Es, Gd^Vhr, Gs, Gd, Hh, Gd, Hh, Mm, Mm
Gs, Gs^Fp, Gs, Gs, Gs, Gs^Vc, Gs^Fp, Re, Re, Gd, Gs, Gs, Gs, Gs^Fp, Gs^Fp, Gs, Gs, Gs, Gs, Gs^Fp, Gs, Gs, Gs, Re, Re, Gs, Gg, Re, Re, Gg, Gs, Gs, Gs^Esd, Rd^Gvs, Rd^Gvs, Rd^Gvs, Rd^Gvs, Gd, Gs, Hh, Mm, Mm
Gs, Gd, Gg, Gg, Gs, Gg, Gll^Fmw, Gll^Fmw, Re, Gll^Fmw, Gs, Gs, Gs^Fp, Gs^Fp, Gs, Gs, Gg, Gg, Gg, Gg, Gg, Gs, Gg, Gs, Re, Gs^Es, Gs, Gs, Gs, Gs, Rd^Gvs, Gs^Es, Re^Gvs, Re^Gvs, Re^Gvs, Rd^Gvs, Gs^Eff, Gd^Eff, Hh, Hh, Mm, Mm
Gs, Gg, Gs, Gg, Gs, Gs^Vc, Gs, Re^Es, Re, Gd, Gs, Gs, Gs, Gs, Gg, Gg, Gg, Gs, Gs, Gs, Gg, Gg, Gg, Gs, Gs, Re, Gs, Gg, Gg, Gd^Eff, Gd^Eff, Rd^Gvs, Rd^Gvs, Re^Gvs, Gs^Eff, Gs, Hh, Hh, Hh, Hh, Hh, Hh
Gs, Gg, Gs, Gs, Gs, Gg, Gs, Gg, Re, Gll^Fmw, Gs, Gs, Gs, Gg, Gg, Gg, Gg, Gg, Gg, Gg, Gg, Gg, Gg, Gs, Re, Re, Re, Gs, Gd, Gg, Gg, Gd^Eff, Gs, Gd^Eff, Gg, Gs, Gg, Hh, Gg, Hh, Hh, Hh
