Gs, Gs, Gs, Gs, Gs, Gs, Gs, Gll^Fp, Gll^Fp, Gs, Gg, Gg, Gg, Wwg, Gg, Gs, Gs^Fp, Gs, Gs, Gs, Gs, Gs^Fp, Gs^Fp, Gs, Gs, Gs, Gs, Gs, Gs^Fp, Gs, Gs, Gs, Gs, Gs, Gll^Fp, Gg
Gs, Gs, Gs, Gs, Gs, Gs, Gs, Gll^Fp, Gll^Fp, Gll^Fp, Gll^Fp, Gg, Gg, Wwg, Gg, Gs^Fp, Gs^Fp, Gs^Fp, Gs, Gs, Gs^Fp, Gs^Fp, Gs, Gs, Gs, Gs, Gs, Gs, Gs, Gs^Fp, Gs, Gs, Hh, Gs, Gll^Fp, Gg
Gs, Gs, Gs, Gs, Gs, Gs, Gs, Gs, Gll^Fp, Gll^Fp, Gll^Fp, Gg, Wwg, Wwg, Gg, Gs^Fp, Gs^Fp, Gs^Fp, Gs, Gs^Fp, Gs^Fp, Gs, Gs, Gs, Gs, Gs, Gs, Gs, Gs^Fp, Gs^Fp, Gs, Gs^Fp, Hh, Hh, Gs, Gll^Fp
Gs, Gs^Fp, Gs^Fp, Gs, Gs, Gs, Gs, Gs, Gll^Fp, Gs, Gll^Fp, Gg, Wwg, Gg, Gg, Gg, Gs^Fp, Gs, Gs^Fp, Gs^Fp, Gs, Gs, Gs, Gs, Gs^Fp, Gll^Fp, Gs, Gs, Gll^Fp, Gll^Fp, Gs, Gs, Gs^Fp, Gs^Fp, Gs, Gll^Fp
Gs^Fp, Gs^Fp, Gs, Gs^Fp, Gs, Gg, Gg, Gs, Gs, Gs, Gg, Gg, Wwg, Gg, Gg, Gg, Gs^Fp, Gs^Fp, Gs^Fp, Gs, Gs, Gs, Gs, Gs, Gs, Gs, Gs, Gs, Gll^Fp, Gll^Fp, Gs, Gs, Gs, Gs, Gs, Gll^Fp
Gs, Gs, Gs^Fp, Gs, Gs, Gs, Gg, Gg, Gg, Gg, Wwg, Wwg, Gg, Gg, Gs^Fp, Gs^Fp, Gs^Fp, Gs^Fp, Gs^Fp, Gs, Gs, Gs, Gs, Gs, Gs, Gs, Gs, Gs, Gs, Gs, Gs, Gll^Fp, Hh, Gs, Gs, Gll^Fp
Gs, Gs, Gs, Gs^Fp, Gs^Fp, Gs, Gg, Gg, Gg, Gg, Wwg, Gg, Gg, Gs^Fp, Gs^Fp, Gs^Fp, Gs^Fp, Gs^Fp, Gs, Gs, Gs, Gs, Gs, Gs, Gs^Fp, Gs, Gs, Gs, Gs, Gs, Gs, Gll^Fp, Gll^Fp, Hh, Gs, Gll^Fp
Ss, Ss, Gs, Gs, Gs^Fp, Gs, Gg, Gs, Gg, Gg, Wwg, Gs^Fp, Gg, Gs, Gs^Fp, Gs^Fp, Gs^Fp, Gs, Gs, Gs, Gs, Hh, Gs, Gs^Fp, Gll^Fp, Hh, Hh, Hh, Gs^Fp, Gs, Gs, Gs, Gll^Fp, Gll^Fp, Gs, Gs
Ss, Ss, Gs, Gs, Gs, Gs, Gs, Gg, Gg, Gg, Wwg, Gg, Gg, Gg, Gs^Fp, Gs^Fp, Gs, Gs, Gs, Gs, Gs, Gs^Fp, Gll^Fp, Gs, Gll^Fp, Gll^Fp, Gll^Fp, Gs^Fp, Gs, Gs, Gs, Gs, Gs, Gs, Gll^Fp, Gll^Fp
Ss, Gll^Fp, Gs, Gs, Gs, Gs, Gg, Gg, Gg, Gg, Wwg, Gg, Gg, Gg, Gs, Gs, Gs, Hh, Gs, Gs, Gs, Gs^Fp, Gll^Fp, Gll^Fp, Gs^Fp, Gll^Fp, Gs^Fp, Gs^Fp, Gs, Gs, Gs, Gs, Gs, Gs, Gll^Fp, Gll^Fp
Gll^Fp, Gll^Fp, Gll^Fp, Gll^Fp, Gll^Fp, Gs, Gg, Gg, Gg, Gg, Wwg, Gg, Gg, Gg, Gg, Gs, Gs, Gs, Gs, Gs, Gs, Gll^Fp, Gll^Fp, Gll^Fp, Gll^Fp, Gs^Fp, Gs, Gs, Gs, Gs, Gs, Gs, Gs, Gs, Gll^Fp, Gll^Fp
Gll^Fp, Gll^Fp, Gs, Gll^Fp, Gll^Fp, Gg, Gg, Gg, Gg, Gg, Wwg, Gg, Gg, Gg, Gg, Gs, Gg, Gg, Gg, Gs, Gg, Gs, Gs, Gs, Gs, Gs, Gs, Gs, Gs, Gs, Gs, Gs, Gs^Fp, Gs^Fp, Gll^Fp, Gll^Fp
Gll^Fp, Gll^Fp, Gs, Gs, Gs, Gs, Gg, Gg, Gg, Gg, Wwg, Gg, Gg, Gg, Gg, Gg, Gs, Gg, Gg, Gg, Gg, Gg, Gs, Gs, Gs, Gs, Gs, Gs, Gs, Gll^Fp, Gll^Fp, Gs^Fp, Gll^Fp, Gll^Fp, Gll^Fp, Gll^Fp
Gll^Fp, Gs, Gs, Gs, Gs^Fp, Gs, Gg, Gg, Gg, Gg, Gg, Wwg, 2 Gg, Gg, Gg, Gg, Gg, Gg, Gg, Gg, Gg, Gg, Gg, Gg, Gs, Gs, Gll^Fp, Gll^Fp, Gll^Fp, Gll^Fp, Gll^Fp, Gll^Fp, Gll^Fp, Gll^Fp, Gll^Fp, Gs^Fp
Gll^Fp, Gll^Fp, Gs, Gs^Fp, Gs^Fp, Gs, Gs, Gs, Gg, Gg, Gg, Wwg, Gg, Gg, Gg, Gg, Gg, Gg, Gg, Gg, Gg, Gg, Gg, Gs, Gs, Gs^Fp, Gs^Fp, Gs^Fp, Gs^Fp, Gll^Fp, Gll^Fp, Gll^Fp, Gll^Fp, Gll^Fp, Gll^Fp, Gs
Gll^Fp, Gll^Fp, Gs, Gs^Fp, Gs^Fp, Gs, Gs, Gs, Gg, Gg, Gg, Wwg, Gg, Gg, Gg, Gg, Gg, Gg, Gg, Gg, Gg, Gs, Gg, Gs, Gg, Gs, Gs, Gll^Fp, Gll^Fp, Gll^Fp, Gll^Fp, Gll^Fp, Gll^Fp, Gll^Fp, Gll^Fp, Gs^Fp
Gll^Fp, Gll^Fp, Gs, Gs, Gs^Fp, Gs^Fp, Gs, Gs, Gg, Gg, Gg, Wwg, Wwf, Gg, Wwg, Gg, Wwg, Gg, Gg, Gg, Gg, Gg, Gs, Gg, Gg, Gg, Gg, Gs, Gs, Gs, Gs, Gll^Fp, Gll^Fp, Gs^Fp, Gll^Fp, Ss
Gll^Fp, Gll^Fp, Gs, Gs, Gs, Gs, Gs^Fp, Gs, Gg, Gg, Gg, Gg, Gg, Wwg, Gg, Wwg, Gg, Wwg, Wwg, Wwg, Wwg, Gg, Gg, Gg, Gg, Gs, Gg, Gs^Fp, Gg, Gg, Gg, Gg, Gg, Gll^Fp, Wwg, Ss
Gll^Fp, Gs, Gs, Gs, Gs^Fp, Gs^Fp, Gs^Fp, Gs, Gg, Gg, Gg, Gg, Gg, Gg, Gg, Gg, Gg, Gg, Gg, Gg, Gg, Wwg, Gg, Gg, Gg, Gg, Wwg, Gg, Wwg, Gg, Wwg, Gg, Wwg, Wwg, Wwg, Wwg
Gs, Gs, Gs, Gg, Gll^Fp, Gll^Fp, Gs^Fp, Gs, Gs, Gg, Gs, Gg, Gg, Gg, Gg, Gg, Gg, Gg, Gg, Gg, Gg, Wwg, Wwg, Wwg, Wwg, Wwg, Gg, Wwg, Gg, Wwg, Gg, Wwg, Gg, Gg, Ss, Wwg
Gs, Gs, Gll^Fp, Gll^Fp, Hh, Hh, Hh, Gs^Fp, Gs^Fp, Gs, Gs^Fp, Gs, Gs, Gs, Gs, Gg, Gs, Gg, Gs, Gg, Gg, Gg, Gg, Gg, Gg, Gg, Gg, Gg, Gg, Gg, Gg, Gg, Gg, Gg, Ss, Wwg
Rr, Gll^Fp, Gll^Fp, Hh, Hh, Hh, Hh, Gs^Fp, Gs^Fp, Gs, Gs, Gs, Gll^Fp, Gs, Gs, Gs, Gs, Gs, Gs, Gs, Gg, Gs, Gs, Gg, Gs, Gs^Fp, Gs^Fp, Gs^Fp, Gs^Fp, Gs, Gs, Gs, Gs, Gg, Gs^Fp, Gg
Gll^Fp, Gll^Fp, Hh, Hh, Gll^Fp, Hh, Hh, Gll^Fp, Gll^Fp, Gs^Fp, Gs, Gs, Gll^Fp, Gll^Fp, Gs, Gll^Fp, Gs, Gs, Gs, Gs, Gs, Gg, Gg, Gs^Fp, Gs^Fp, Gs, Gs, Gs, Gs^Fp, Gs^Fp, Gs, Gs, Gs, Gs, Gs, Gs^Fp
Gll^Fp, Gll^Fp, Hh, Hh, Gll^Fp, Gll^Fp, Hh, Hh, Hh, Gs^Fp, Gs, Gs, Gll^Fp, Gll^Fp, Gs^Fp, Gll^Fp, Gs^Fp, Hh, Gs, Gg, Gs, Gs, Gs, Gs, Gs^Fp, Gs^Fp, Gs, Gs^Fp, Gs, Gs, Gs, Gs, Gs, Gs, Gs, Gs^Fp
Gll^Fp, Gll^Fp, Gll^Fp, Hh, 1 Gll^Fp, Gs^Fp, Gll^Fp, Hh, Gll^Fp, Gs^Fp, Gs^Fp, Gs, Gs, Gll^Fp, Ss, Gll^Fp, Gs^Fp, Gs^Fp, Gs^Fp, Hh, Gs, Gg, Gg, Gs, Gs, Gs, Gs, Gs, Gs, Gs, Gs, Gs, Gs, Gs, Gs, Gs^Fp
Gs, Gs, Hh, Hh, Gs, Gs, Gs, Hh, Gll^Fp, Gll^Fp, Gs^Fp, Gs^Fp, Gs, Gs^Fp, Ss, Ss, Gs, Gs^Fp, Gs^Fp, Gs, Gs, Gs, Gs, Gs, Gs, Gs, Gs, Gs, Gs, Gg, Gs, Gs, Gs, Gs, Gs^Fp, Gs^Fp
Hh, Hh, Gll^Fp, Gs, Gs, Gs, Gs, Gs, Gll^Fp, Gll^Fp, Gs, Gs^Fp, Gs, Gs^Fp, Gs^Fp, Gs^Fp, Gs^Fp, Gs^Fp, Gs^Fp, Gs, Hh, Gg, Gg, Gs, Gs, Gg, Gg, Gs, Gg, Gg, Gg, Gg, Gs, Gs, Gs, Gs^Fp
Hh, Hh, Gll^Fp, Gs, Gs, Gs^Fp, Gll^Fp, Gs, Gll^Fp, Gs, Gs, Gs, Gs, Gs, Gs, Ds, Ds, Gs^Fp, Gs, Gs, Gs, Gs, Gs, Gg, Gg, Gs, Gg, Gs, Gg, Gs, Gg, Gs, Gs, Gs, Gs^Fp, Gs^Fp
Gs, Hh, Hh, Gll^Fp, Gll^Fp, Gll^Fp, Hh, Hh, Hh, Hh, Gs, Gg, Gg, Gs, Gs, Gs, Ds, Gs, Gs, Gs, Gs, Hh, Gs, Gs, Gg, Gg, Gg, Gg, Gg, Gg, Gs, Gs, Gs^Fp, Gs^Fp, Gs^Fp, Gs^Fp
Gs, Hh, Hh, Hh, Hh, Hh, Hh, Hh, Gll^Fp, Gll^Fp, Gs, Gs, Gs, Gg, Gs, Aa, Aa, Gs, Gs, Gg, Gs, Gs, Gs, Gs, Gs, Gg, Gg, Gg, Gg, Gg, Gs, Gs, Gs^Fp, Gs^Fp, Gs^Fp, Gs^Fp
