Gll, Gs, Gll^Fmf, Ss, Gll, Ss, Ss, Gll^Fmf, Ss, Gs, Sm, Gs, Ss, Wwg, Aa, Aa, Aa^Fmf, Gs, Wwg, Wwg, Wwg, Wwg, Wwg, Wwg, Wwg, Gs, Wwg, Wwg, Wwg, Wwg, Wwg, Aa, Gs
Gll, Ss^Fmf, Ss^Fmf, Ss, Aa, Wwg, Wwg, Ss, Gll^Fmw, Ss, Gll^Fdf, Ai, Ss, Ss, Rb, Aa^Fmf, Aa^Fda, Aa^Fda, Aa, Aa, Aa^Fda, Aa^Fmf, Gs, Wwg, Wwg, Wwg, Wwg, Wwg, Aa^Fmf, Wwg, Wwg, Wwg, Wwf
Sm, Sm, Sm, Rb^Fmf, Rb, Gll^Fdw, Ai, Sm, Gll^Fmf, Gll^Fmw, Sm, Aa, Aa, Rb, Rd, Aa^Fmf, Aa^Fda, Aa^Fmf, Ha^Fmw, Aa^Fmf, Gll^Fmf, Gs, Gs, Aa, Gs, Gs, Gs, Ha, Aa^Fpa, Aa^Fp, Aa^Vha, Wwf, Wwf
Aa, Sm, Ss, Rb, Ss, Ai, Rb, Aa, Aa, Rb, Aa^Fma, Aa^Fma, Gs, Gll, Aa, Aa, Aa^Fmf, Aa^Fma, Ha^Fma, Gll^Fdf, Gs, Gs, Gs, Gs, Gll^Fmf, Gll^Fp, Gs, Aa, Aa^Fdf, Aa^Fma, Gs, Wwf, Wwg
Gll^Fmf, Ss, Rb, Ss^Fdw, Rb, Sm, Aa^Fda, Sm, Rd, Gll, Aa, Aa, Gs, Aa, Gs^Vh, Aa, Aa^Fma, Ha^Fma, Aa^Fma, Gs, Gs, Gs, Gs, Gs, Gs, Gs, Aa, Gs, Gll^Fmf, Aa^Fma, Gs, Aa, Wwg
Ss, Rb, Sm, Ss, Sm^Fdw, Aa^Fda, Gll, Gll, Re, Aa, Gs, Gs, Aa, Gs, Aa, Aa, Aa^Fmf, Aa^Fma, Aa^Fdf, Gs, Gs, Re, Gs, Gs, Aa, Aa, Gs, Gs, Gs, Gs, Gs, Aa^Fmf, Gll^Fdf
Ss, Rb, Ss, Gll^Fmw, Rb, Aa, Aa, Gs, Gs, Gs, Gs, Gs, Gs, Gs, Gs, Gs, Gs, Aa^Fdf, Gs, Gs, Re, Gs, Gs, Gs, Gll^Fdf, Gs, Gll^Fdf, Gs, Gll^Fdf, Gs, Aa, Aa^Fda, Gll^Fmf
Rb, Ai, Aa, Aa, Aa, Gll, Aa, Aa, Gs, Gs, Aa^Fdf, Aa^Fdf, Gs, Gs, Gs, Gs, Gs, Gs, Aa, Re, Gs, Gs, Gs, Aa^Fma, Aa^Fmf, Hh, Hh, Hhd, Gll^Fdf, Gs, Gs, Aa, Aa^Fmf
Ss, Rb, Rb, Sm, Aa^Fmw, Aa^Fmw, Aa, Aa, Gs, Gs, Aa^Fdf, Aa, Gs, Gs, Gs, Gs, Gs, Aa, Gs, Aa, Gs, Gs^Fp, Gs, Gs, Gll^Fmw, Aa^Fmf, Aa^Fma, Aa^Fmf, Aa, Aa, Gs, Aa, Aa
Ss, Gll^Fmf, Gll, Sm, Gll, Gs^Vh, Gs, Gs, Gs, Gs, Gs, Gs, Gs, Gs, 2 Re, Re, Re, Re, Re, Re, Gs, Gs, Gs, Gg, Aa^Fma, Aa^Fmw, Aa^Fda, Aa^Fda, Gs, Gs, Gs, Aa, Gs
Aa^Fmf, Aa^Fmw, Aa^Fmw, Gll^Fmf, Gll^Fmf, Gs, Aa, Aa, Gs, Gs, Gs, Gs, Gs, Re, Aa, Re, Gs, Re, Gs, Gs, Gs, Gs, Aa^Vha, Aa^Fma, Aa^Fma, Aa^Fda, Aa^Fma, Aa, Aa^Fmf, Aa, Gs, Aa^Fda, Aa
Aa^Fmf, Aa^Fmf, Aa^Fda, Aa^Fmf, Gll^Fmf, Gs, Gs, Aa, Aa, Re, Gs, Gs, Gs, Gs, Aa^Fda, Gs, Gs, Gs, Gs, Re, Gs, Aa, Gs, Aa, Gs, Gs, Gs, Aa, Gs, Aa, Aa^Fmf, Aa^Fda, Aa^Fmf
Aa^Fmf, Aa^Fda, Aa^Fmw, Aa^Fmw, Gs, Aa, Gs, Gs, Gs, Gs, Gs, Gs, Gs, Aa, Aa^Fda, Aa^Fdf, Aa^Fda, Aa, Gs, Re, Re, Gs, Gs, Gs, Gs, Gs, Gll^Fdf, Gs, Aa^Vla, Aa^Fmf, Gll^Fda, Gll^Fmf, Aa^Fmf
Aa^Fmf, Aa^Fmw, Aa^Fmw, Aa^Vha, Gs, Aa, Gs, Re, Gs, Gs, Gs, Gs, Aa^Fdw, Aa^Fdf, Ha, Aa^Fdw, Aa^Fdf, Gs, Gs, Gs, Gs, Gs, Gll^Fmf, Gll^Fmf, Gll^Fmw, Gll^Fmf, Aa^Fmw, Aa^Fmw, Aa^Fma, Aa^Fma, Aa^Fma, Ha^Fda, Aa^Fmf
Gll^Fmf, Aa^Fda, Aa, Gs, Gs, Gs, Gs, Gs, Gs, Gs, Gll^Fdw, Aa^Fmf, Aa^Fmf, Ha^Fdf, Hh^Fdf, Hh^Fmf, Aa^Fmf, Aa^Fdf, Gs^Fmf, Gs, Gs, Gll^Fdf, Gs, Gll^Fmf, Gs, Gll^Fmw, Gll^Fmf, Aa^Fmf, Aa^Fma, Aa^Fmf, Ha^Fmf, Ha^Fma, Ha^Fmf
Gll^Fmf, Gll^Fmf, Gs, Gs, Gs, Gs, Gs, Gs, Gs, Gs, Gs, Aa, Aa^Vha, Hh^Fmf, Hh^Fmf, Ha^Fma, Ha^Fmf, Aa^Fmf, Gs^Vh, Gs, Gll^Fdf, Gll^Fdf, Gll^Fdf, Gll^Fmf, Gs, Gll^Fmf, Gll^Fdf, Gll^Fdw, Gll^Fmw, Gll^Fdf, Ha^Fma, Ha^Fmf, Ha^Fmf
Aa, Aa, Ce, Gs, Gs, Gs, Gs, Aa, Gs, Gs, Aa^Fdf, Gs, Aa^Fma, Hh^Fmf, Hh^Fdf, Hh^Fdf, Hhd, Aa^Fma, Aa^Fmf, Gll^Fmf, Aa^Fmf, Gll^Fdf, Gll^Fdw, Gll^Fdf, Gs, Gs, Ce, Gll^Fdf, Gll^Fdf, Hh^Fdw, Hh^Fmf, Aa^Fma, Aa^Fmf
Gg, Cea, 1 Ke, Ce, Gs, Aa, Aa, Gs, Aa^Fma, Aa, Aa^Fdf, Aa^Fdf, Aa^Fmf, Hh^Fmf, Hh^Fdf, Ms, Ha, Ha^Fdf, Ha^Fdf, Gs^Fmf, Aa^Fdf, Aa^Fmw, Gll^Fdf, Gd^Fmf, Gll^Fmf, Ce, 3 Ke, Ce, Aa^Fmf, Hh^Fdw, Gll^Fp, Aa^Fdf, Gs
Gg, Ce, Cea, Ce, Gs, Gs, Gll^Fmf, Gll^Fmw, Aa^Fmw, Aa^Fma, Aa, Aa, Hh^Fmf, Ha^Fdf, Ha, Ms, Mm, Hh, Hh, Aa^Fmf, Aa^Fmw, Aa^Fdf, Gll^Fdf, Gll^Fmf, Aa^Fmf, Cea, Aa^Fmf, Cea, Aa^Fma, Aa^Fmf, Wwg, Gll^Fdf, Wwg
Aa, Aa, Aa, Aa^Fmw, Aa^Fmf, Gs^Vh, Gll^Fmw, Gll^Fmf, Gll^Fmw, Aa^Fmf, Aa^Fma, Aa^Fmf, Hh^Fmf, Ha^Fdf, Mm, Mm, Ms, Ms, Hh, Gll^Fmw, Aa^Fmw, Aa^Fmf, Gll^Fdf, Wwg^Fmf, Wwg, Aa^Fmf, Ai, Aa^Fmf, Wwg, Wwg, Ai, Wwg, Wwg
Aa, Aa, Gll^Fmf, Aa^Fmf, Ha, Ha, Ha, Hh, Aa^Fma, Aa^Fmf, Aa^Fma, Gs^Fmf, Hhd, Ha, Ms, Mm, Ms, Ms, Ms, Aa^Fmf, Aa^Fmf, Gll^Fdw, Gs, Wwg, Wwg, Wwg, Wwg, Wwg, Wwg, Wwg, Aa, Aa^Fma, Aa
Rr, Gll^Fmf, Gll^Fmf, Hh, Ha, Hh, Ha, Ha, Ha, Aa^Fmw, Hh, Hh, Hhd, Ms, Ms, Ms, Ms, Ms, Ms, Ms, Aa^Fma, Aa^Fma, Aa^Fma, Wwg, Wwg, Aa^Fma, Ha, Aa^Fma, Aa, Gs, Ha, Aa^Fma, Aa
Gll^Fmf, Gll^Fmf, Hh, Ha, Gll^Fmf, Hh, Hh, Ha, Ha, Ha, Hh, Hhd, Ha, Ha, Ms, Ms, Ms, Ms, Ms, Ms, Ha, Aa^Fma, Aa^Fma, Wwg, Wwg, Aa, Gs, Gs, Aa, Aa^Fp, Ha^Fp, Ha, Ha^Fp
Gll^Fmf, Gll^Fmf, Hh, Hh, Gll^Fmf, Gll^Fmf, Hh, Mm, Aa, Mm, Mm, Mm, Ms, Ms, Mm, Ms, Ms, Ms, Mm, Ms, Ha, Aa^Fma, Aa^Fma, Wwg, Wwg, Aa, Ha^Fp, Aa^Fp, Ha^Fp, Ha^Fp, Ha, Aa^Fp, Aa
