Gs, Gll^Fp, Gll^Fmw, Gll^Fp, Gll^Fp, Hh, Mm, Mm, Mm, Gll^Fp, Gll^Fp, Gll^Fp, Gll^Fp, Gll^Fmw, Gs, Gll^Fp, Gs, Gs, Gs, Gs, Gs, Gll^Fp, Gll^Fp, Hh, Gll^Fp, Gll^Fp, Hh, Mm, Mm, Mm
Gll^Fp, Gll^Fp, Gll^Fp, Gll^Fmw, Gll^Fp, Hh, Mm, Mm, Hh, Hh, Hh, Hh, Hh, Gll^Fmw, Gll^Fp, Gll^Fp, Gs, Gs, Re, Gs, Gs, Gs, Gll^Fp, Hh, Gll^Fp, Hh, Mm, Mm, Mm, Mm
Gll^Fp, Gll^Fp, Hh^Es, Gll^Fmw, Gll^Fp, Hh, Hh, Hh, Hh^Es, Gll^Fp, Gll^Fp, Hh, Hh, Gll^Fp, Gll^Fp, Gs^Em, Gll^Fp, Gs^Es, Gs, Gs, Gll^Fp, Gll^Fp, Gll^Fmw, Gll^Fp, Gll^Edb, Hh, Hh, Mm, Mm, Mm
Hh, Hh, Gll^Fp, Gll^Fp, Gll^Fmw, Gll^Fp, Hh, Hh, Hh, Hh, Gll^Fp, Gll^Fp, Gll^Fp, Gll^Fp, Gll^Fmw, Gll^Fp, Gll^Fmw, Gs, Re, Gs, Gll^Fp, Gll^Fp, Gll^Fmw, Gll^Fp, Gll^Fp, Gs^Em, Hh, Hh, Mm, Mm
Hh, Gll^Fp, Gll^Fmw, Gll^Fmw, Gll^Fp, Gll^Fp, Gll^Fp, Gll^Fp, Gll^Fp, Hh, Gll^Fp, Gll^Fp, Gll^Fmw, Gll^Fmw, Gll^Fp, Gll^Fmw, Gs, Gs, Re, Gs, Gll^Em, Gll^Fp, Gll^Fmw, Gll^Fp, Gll^Fp, Hh, Hh, Hh, Mm, Mm
Hh, Gll^Fp, Gll^Fp, Gll^Fmw, Gll^Edb, Gs, Gs, Gll^Em, Gll^Fp, Hh, Gll^Fp, Gll^Fp, Gll^Fp, Gll^Fp, Gs^Efm, Gs, Re, Re, Gs, Gs, Gll^Fp, Gll^Fmw, Gll, Gll^Fp, Gll, Hh^Es, Hh, Mm, Mm, Mm
Gll^Fp, Gll^Fp, Gll^Fp, Gll^Fp, Gs, Gll^Fp, Gll^Fp, Gll^Fmw, Gll^Fp, Gll^Fp, Gll^Fp, Gll^Fmw, Gll^Fp, Gll^Fp, Gs^Es, Gs, Gs, Gs, Gll^Fmw, Gll^Fmw, Gll^Fp, Gll^Fp, Gll^Fp, Gll^Fp, Gll, Hh, Hh, Mm, Mm, Mm
Gll^Fp, Gll^Fp, Gll^Fmw, Gll, Gll^Fp, Gll^Fp, Gll^Fp, Gll, Gll^Fp, Gll^Fp, Gll^Fmw, Gll^Fp, Gll, Gll^Fp, Gs, Gs, Gs, Gll^Fp, Gll^Fp, Gll^Fp, Gll^Fp, Gll^Fp, Gs^Em, Gs, Gs, Gs, Hh^Es, Hh, Hh, Mm
Gll^Fp, Gll^Fp, Gll^Fp, Gs, Gll^Fp, Gll^Fp, Gs, Gll^Fp, Gs, Gll^Fp, Gll^Fp, Gll, Gg^Efm, Gg, Re, Re, Gs, Gll^Fp, Gll^Fp, Gll, Gll^Fp, Gll^Fp, Gll^Fp, Hh, Hh, Hh, Hh, Hh, Hh, Hh
Gs, Gll^Em, Gg, Gs, Gll^Fp, Gll, Gll^Fp, Gs, Gs, Gll^Fmw, Gg, Gg, Gs, Gs, Re, Gs, Gll^Fp, Gll^Fp, Gll^Fp, Gll^Fp, Hh, Gll^Fp, Hh, Gll^Fp, Hh^Es, Hh, Mm, Mm, Mm, Mm
Gs, Gs, Gs, Gs, Gs, Gs, Gs, Gs, Re, Gs, Gs^Es, Gs, Re, Re, Gs, Gs, Gll^Fp, Hh, Hh, Gll^Fp, Gll^Fp, Gll^Fp, Gll^Fp, Gll^Fp, Gll^Fp, Hh, Mm, Mm, Mm, Mm
Gs, Gs, Re, Re, Gs, Re, Re, Re, Gs, Re, Re, Re, 1 Re, Gs^Es, Gg^Efm, Gll^Fp, Gll^Fp, Hh, Gll, Gll, Gll^Fp, Gll^Fp, Gll^Fp, Gll^Fmw, Gll^Fp, Hh, Hh, Mm, Mm, Mm
Gll, Gs, Hh, Gll^Fp, Gll^Fp, Gs, Gs, Gs, Gs, Gs, Gll^Fp, Re, Gs, Re, Gs, Gll^Fp, Gll^Fp, Gll^Em, Gll^Fp, Gll^Fp, Gs, Gs, Gs^Es, Gll^Fp, Gll^Fmw, Gll^Fp, Hh, Mm, Mm, Mm
Hh, Hh, Hh, Gll^Fp, Ww, Gs^Es, Gll^Fmw, Gs, Gs, Gs, Gs, Gll^Fp, Gs, Re, Gs, Gs, Gs, Gll^Fmw, Gll^Fp, Gll, Gs, Gs, Hh, Gll, Hh, Gll^Fp, Hh, Hh, Mm, Mm
Mm, Mm, Hh, Hh, Ww, Ww, Gll^Fmw, Gs, Gs, Gs, Gll^Fp, Gs, Gs, Gs, Gs, Gs, Gs, Gll^Fmw, Gs, Gs, Gs, Hh^Es, Hh, Hh, Hh, Gll^Fp, Gll^Fp, Hh, Mm, Mm
Mm, Mm, Hh^Es, Wwr, Ww, Gll^Fp, Gs, Gs, Gll^Fp, Gll^Fp, Gll^Fp, Gll^Fp, Gll^Fp, Gll^Fp, Gs, Re, Re, Gs, Gs, Gs, Gs, Hh, Mm, Mm, Mm, Gll^Fp, Hh, Mm, Mm, Mm
Hh, Mm, Wwr, Ww, Ww, Gs^Efm, Gs, Gs, Gs, Gll^Fp, Gll^Fmw, Gll^Fp, Gll^Fp, Gs, Gs, Gs, Gs, Re, Gs^Es, Gs, Gs, Hh, Mm, Mm, Mm, Hh, Hh, Mm, Mm, Mm
Hh, Hh, Ww, Ww, Ww, Ww, Gs, Gll^Fp, Gll^Fp, Gll^Fp, Gll^Fp, Gll^Fp, Gll^Fp, Gll^Fp, Gll^Fp, Gs, Gs, Re, Gs^Efm, Gs, Gll^Fp, Hh, Mm, Mm, Mm, Hh, Hh^Es, Mm, Mm, Mm
Gll^Fp, Ww, Ww, Ww, Ww, Gs, Gs, Gll^Fp, Gll^Fp, Gs^Em, Gll, Gll^Fp, Gll^Fp, Gg, Gll^Fp, Gs, Gs, Re, Gs^Efm, Gs, Gll^Fmw, Hh, Hh, Mm, Hh, Hh, Hh, Mm, Mm, Mm
Gll^Fp, Ww, Gs, Gs, Gs, Gs, Gll^Fp, Gll^Fp, Gll^Fp, Gll^Fp, Gll^Fp, Gll^Fp, Gll^Fp, Gll, Gll^Fp, Gll^Fp, Gs^Es, Re, Gs, Gs, Gll^Fmw, Gll^Fp, Gll^Fp, Hh, Gll^Fp, Gll^Fp, Hh, Hh, Mm, Mm
Gs, Gs^Es, Gs, Gs, Gs, Gs^Es, Gll^Fp, Gll^Fp, Gll^Fmw, Gll^Fp, Gll^Fp, Gll^Fp, Gs, Gll^Fp, Gs, Gs, Gs, Re, Gll^Fp, Gs, Gll^Fp, Gll^Fp, Gll^Fp, Gll^Fmw, Gll^Fp, Gll^Fp, Gll^Fp, Hh, Hh^Es, Mm
Gll^Fp, Gs, Gll^Fp, Gll^Fp, Gll^Fp, Gll^Fp, Gll^Fp, Gll^Fp, Gll^Fp, Gll^Fp, Gll^Fp, Gs^Es, Gs^Efm, Gs, Gs, Re, Gg, Gll^Fp, Gll^Fp, Gll^Fp, Gll^Fp, Gll^Fp, Gll^Fp, Gll^Fp, Gll^Fp, Gll^Fp, Gll^Fp, Hh, Hh, Hh
Gll^Fp, Gll^Fmw, Gll^Fp, Gll^Fp, Gll^Fp, Gll^Fp, Gll, Gll^Fp, Gll^Fp, Gll^Fp, Gll^Fp, Gs, Gs^Efm, Gg^Efm, Gs, Re, Re, Gll^Fp, Gs, Gll^Fp, Gs, Gll^Fp, Gll^Fp, Gll^Fp, Gll^Fp, Gs^Em, Hh, Hh, Mm, Mm
