Aa^Fpa, Aa^Fpa, Aa^Fpa, Aa^Fpa, Aa^Fpa, Aa^Fpa, Aa^Fpa, Aa^Fpa, Aa^Fpa, Aa, Aa^Fp, Gg, Gll^Fp, Gg, Aa^Fpa, Gll^Fp, Gll^Fp, Gll^Fp, Gd^Vo, Gg, Gll^Fp, Gll^Fp, Aa^Fpa, Aa^Fpa, Aa^Fpa, Gll^Fp, Gll^Fp, Gg, Gs, Re, Gg^Es, Gs, Gll^Fp, Aa^Fpa, Aa^Fpa, Ha, Ha, Ms, Ms, Mm, Ms, Ms
Aa^Fpa, Aa^Fpa, Aa^Fmw, Aa^Fp, Gll^Fp, Aa^Es, Gll^Fp, Aa^Fpa, Gll^Fmw, Aa^Fp, Gll^Fp, Gll^Fp, Gll^Fp, Aa^Fp, Gll^Fp, Aa^Fpa, Aa, Gll^Fp, Gll^Fp, Gll^Fmw, Gll^Fp, Aa^Fpa, Gll^Fp, Aa^Fpa, Aa^Fp, Aa^Fpa, Gll^Fp, Gll^Fp, Gs, Re, Gs^Es, Gs, Gll^Fp, Aa^Fpa, Aa^Fpa, Ha, Ha, Ms, Ms, Ms, Ms, Ms
Aa^Fpa, Aa^Fmw, Aa^Fpa, Aa, Gll^Es, Gll^Fp, Gll, Gll^Fp, Gll^Fp, Gs, Gd^Vo, Gll^Fp, Gll, Gll^Fmw, Ha, Aa^Fp, Ha, Gll^Fp, Gll, Gll^Fp, Gll^Fp, Gll^Fp, Gll^Fmw, Gll^Fmw, Aa^Fmw, Aa^Fpa, Aa^Fpa, Gll^Fp, Gll^Fp, Re, Re, Gs^Es, Gll^Fp, Gll^Fp, Aa^Fpa, Ha, Ha, Mm, Ms, Ms, Ms, Ms
Aa, Aa^Fpa, Aa^Fpa, Gll^Fp, Aa^Fp, Gll^Fp, Aa^Fp, Gll^Fp, Aa^Fp, Gll^Fmw, Gll^Fp, Gll^Fp, Gll^Fp, Gll^Fmw, Gll^Fp, Ha, Gll^Fp, Ha, Hhd, Hhd, Hhd, Gll^Fp, Hhd, Gs^Es, Hhd, Aa^Fpa, Aa^Fpa, Gll^Fp, Gll^Fp, Re, Gs, Gll^Fp, Gll^Fp, Gll^Fp, Gll^Fp, Ha, Hh, Mm, Mm, Ms, Ms, Ms
Aa^Fp, Aa^Fp, Gll^Fp, Gll^Fp, Aa^Fp, Aa^Fp, Aa^Fpa, Aa^Fp, Aa^Fp, Aa^Fp, Aa^Fp, Gll^Fp, Aa^Fpa, Aa^Fpa, Aa^Fpa, Gll^Fp, Gll^Fp, Gll^Fp, Hhd, Hhd, Gll^Fp, Ha, Hhd, Gll^Fp, Ha, Rb, Aa^Fpa, Aa^Fmw, Gll^Fp, Re, Re, Gll^Fp, Gll^Fp, Gd, Gll^Fp, Gd, Gll^Fp, Mm, Mm, Mm, Ms, Ms
Gs^Fp, Gll^Fmw, Gs^Fp, Gll^Fp, Gll^Fmw, Gll^Fp, Gll^Fp, Aa^Fpa, Aa^Fmw, Aa^Fp, Gll^Fp, Aa^Fmw, Gll^Fp, Aa^Fp, Aa^Fp, Gll^Fmw, Gll^Fp, Gll^Fp, Gll^Fp, Gll^Fp, Hhd, Gll^Fp, Gll^Fmw, Hhd, Gll^Fp, Aa^Fp, Aa^Fp, Aa^Fpa, Gll^Fp, Gs, Re, Gs, Aa^Fp, Gll^Fp, Gll^Fp, Gll^Fp, Gll^Fmw, Gll^Fp, Mm, Mm, Mm, Ms
Gll^Fp, Gll^Fp, Gll, Gll^Fp, Rb^Es, Gll^Fp, Gll^Fp, Gll^Fmw, Gll^Fp, Gll^Fp, Gll^Fp, Gll^Fp, Hhd^Vo, Gll^Fp, Gll^Fmw, Aa^Fp, Gll^Fp, Gs^Fp, Gll^Es, Gll^Fp, Hhd, Aa^Voa, Hhd, Hhd, Hhd^Es, Hhd, Hhd, Gll^Fp, Gs^Em, Gll^Fmw, Re, Gs, Aa^Fpa, Aa^Fp, Hh, Hh, Gll^Fp, Hh, Ms, Ms, Ms, Ms
Re, Rb^Es, Hhd, Rb, Hhd^Vo, Rb, Rb, Gll^Fmw, Rb^Es, Hhd, Hhd, Hhd, Hhd, Hhd, Gll^Fp, Gll^Fmw, Gll^Fp, Gll^Fp, Hhd^Es, Hhd, Ha, Ha, Ha, Ha, Ha, Gll^Fp, Gll^Fp, Gll^Fp, Gll^Fp, Gs, Gll^Fmw, Gll^Fp, Aa^Fpa, Aa^Fp, Hh, Hh, Gll^Fp, Hh^Es, Ms, Ms, Ms, Ms
Re^Es, Hhd, Ms, Hhd, Rb^Es, Rb^Es, Co, Rb^Es, Ha, Ms, Ms, Mm, Mm, Hhd^Es, Gs^Fp, Gs^Fp, Gll^Fp, Hhd, Hhd, Hhd, Gll^Fp, Ha, Gs^Es, Ha, Ha, Gll^Fp, Gd^Vo, Gll^Fp, Gll^Fmw, Re, Gs^Es, Aa^Fp, Aa^Fp, Hh^Es, Hh, Gs, Gll^Fp, Hh, Ms, Ms, Ms, Ms
Ha, Ms, Ms, Hhd, Ms, Co, 2 Ket, Co, Ms, Ms, Ha, Ha, Mm, Hhd, Gll^Fmw, Gll^Fet, Gll^Fp, Gll^Fp, Gll^Fp, Gll^Fp, Gs, Gll^Fp, Gll^Fp, Ha, Gll^Fp, Gll^Fp, Gs^Es, Gll^Fp, Re, Gs, Gll^Fp, Aa^Fpa, Aa^Fp, Gll^Fp, Gll^Fp, Gll^Fp, Hh^Es, Hh, Hh, Ms, Ms, Ms
Re, Ha, Ha, Ms, Ms, Co, Ce, Ce, Mm, Aa^Voa, Hhd, Re^Es, Re, Hhd, Hhd, Gll^Fp, Gll^Fmw, Gll^Fp, Gs^Em, Gll^Fmw, Gll^Fp, Gll^Fp, Re^Es, Gll^Fmw, Re, Gll^Fp, Re, Re, Gll^Fp, Gll^Fp, Aa^Fp, Aa^Fpa, Gll^Fp, Gll^Fp, Re, Gll^Fp, Hh, Hh, Ms, Ms, Ms, Ms
Gll^Fmw, Re^Es, Re, Ms, Ms, Aa^Voa, Mm, Mm, Mm, Mm, Mm, Hhd, Re, Hhd, Re^Es, Gll^Fp, Gll^Fp, Gll^Fp, Gll^Fp, Gll^Fp, Re, Re, Re, Re, Re^Es, Re, Gs, Gs, Gs, Gll^Fp, Gd^Fetd, Gll^Fp, Gs, Gll, Gll^Ecf, Re, Gd^Vo, Hh, Ms, Ms, Ms, Ms
Gll^Fp, Gll^Fdw, Re, Ha, Mm, Mm, Ha, Mm, Ha, Ha, Ha, Mm, Hhd, Re^Es, Re, Re, Re, Re, Re, Re, Gll^Fp, Gs, Gll^Fp, Gll^Fp, Gll^Fmw, Re, Gs, Gll^Fp, Gll^Fp, Gll^Es, Aa^Fma, Gll, Hh^Es, Hh, Gll^Fp, Gll^Fp, Hh^Es, Hh, Ms, Ms, Ms, Ms
Re^Es, Re, Ha, Mm, Ha, Mm, Mm, Re^Es, Re, Hhd, Re^Es, Hhd, Ha, Re, Gll^Fmw, Gll^Fp, Aa^Fp, Gll^Fp, Aa^Fp, Aa^Fpa, Aa^Fp, Gll^Fp, Gll^Fp, Gll^Fp, Gll^Fp, Re, Re, Gll^Fp, Gll^Fmw, Aa^Fp, Aa^Fpa, Hh, Hh, Hh, Gll^Fp, Hh, Hh, Hh, Ms, Ms, Ms, Ms
Re, Re, Ha, Mm, Re, Ha, Ha, Mm, Hhd, Re, Hhd^Vo, Re, Gd^Fp, Re, Re^Es, Gs^Fp, Gs^Fp, Aa^Fp, Gd^Em, Aa^Fpa, Aa^Fp, Gll^Fp, Gll^Fmw, Gll^Fp, Gll^Fp, Gll^Fp, Gll^Fp, Gs, Aa^Fp, Aa^Fpa, Hh, Hh, Gll^Fp, Gll^Fp, Hh, Gll^Fp, Gll^Fp, Hh, Ms, Ms, Ms, Ms
Re^Es, Re, Hhd, Hhd, Re^Es, Re, Re, Hhd, Gd^Fp, Hhd, Gd^Fp, Gd^Fp, Re^Es, Re, Re, Gd^Fp, Gd^Fet, Gs^Fp, Aa^Fpa, Gll^Fmw, Aa^Fpa, Gll^Fp, Gll^Fp, Gd^Vo, Gs^Es, Gll^Fmw, Gs, Gs, Gs, Gll^Fmw, Gll^Fp, Gll^Fp, Gs, Gs^Em, Hh, Gll^Fp, Hh, Hh, Ha, Ms, Ms, Ms
Gs^Fp, Gd^Fp, Gd^Fp, Hhd, Re, Gd^Fp, Gd^Vc, Re, Re, Gd^Fmw, Gd^Fp, Gs^Fmw, Re^Edb, Re^Es, Re, Gs^Fp, Aa^Fma, Aa^Fp, Gs^Es, Aa^Fpa, Aa^Fp, Aa^Fp, Aa^Fma, Gs, Aa, Aa, Re^Es, Aa, Gll^Fp, Gll^Fp, Gs, Gll^Fp, Gs, Gll^Fp, Hh, Hh, Hh^Es, Ha, Ha, Ha, Ms, Ms
Gd^Fp, Re, Re, Re, Re, Gd^Fp, Gd^Fp, Gd^Fp, Re, Aa^Fp, Re, Gs^Fp, Gs^Fp, Re, Gs^Es, Gs^Fp, Aa^Fma, Aa^Fma, Gg, Gs, Aa^Fp, Aa^Fp, Aa^Fma, Aa^Fp, Aa^Fp, Re, Gs, Gll^Fp, Gll^Fp, Gll^Fmw, Gs, Gs, Gll^Fp, Gll^Fp, Hh, Hh, Hh, Hh^Es, Ha, Ms, Ms, Ms
Gs^Fp, Re, Re, Re, Gs^Fp, Gs^Fp, Gs^Fp, Re, Re, Aa^Fp, Aa^Fp, Gs^Fmw, Gs^Fp, Re, Gs^Vc, Gll^Fp, Gll^Fp, Aa^Fp, Gll^Fmw, Gs, Aa^Fp, Aa^Fma, Aa^Fma, Aa^Fma, Aa^Fp, Aa, Aa, Gll^Fp, Gll^Fp, Gs^Es, Gll^Fmw, Gll^Fp, Gll^Fp, Gll^Fp, Gll^Fp, Gll^Fmw, Hh, Ha, Ha, Ms, Ms, Ms
Gs^Fmw, Gs^Fp, Gs^Vo, Re, Gs^Fp, Gg^Fet, Gs^Fp, Re, Aa^Fp, Aa^Fp, Aa^Fmw, Gs^Fp, Gs^Fp, Re, Re, Gll^Fp, Gll^Fp, Gll^Fp, Gll^Fp, Gg, Gs, Aa^Fp, Aa^Fp, Aa^Fma, Aa, Aa, Gll^Fmw, Aa^Voa, Gll^Fp, Gll^Fp, Hh, Gll^Fp, Gd^Fetd, Gll^Fp, Gll^Fp, Gll^Fmw, Hh^Es, Ha, Ha, Ms, Ms, Ms
Gs^Fp, Gs^Fp, Gs^Fp, Re, Aa^Fp, Aa^Fmw, Aa^Fp, Aa^Fp, Gs^Fp, Gs^Fp, Aa^Fp, Aa^Fpa, Aa^Fp, Gs^Fp, Gs^Fp, Re, Re, Gs, Gs, Gll^Fp, Gs, Aa, Aa, Aa, Aa^Fp, Aa, Gs, Gll^Fp, Gll^Fp, Gll^Fmw, Hh, Aa^Fp, Gll^Fp, Gs^Es, Hh, Hh, Ha, Ha, Ms, Ms, Ms, Ms
Gs^Fp, Gs^Fp, Re, Re, Aa^Fp, Aa^Fp, Gs^Fp, Gs^Fp, Gs^Fp, Gs^Vc, Gs, Aa^Fpa, Aa^Fpa, Gg^Fet, Gs^Fp, Gs, Gs, Re, Re^Es, Gs, Gll^Fp, Aa^Fp, Aa^Fp, Aa^Fp, Gll^Fp, Gs, Gs, Gll^Fp, Gll^Fp, Hh, Aa^Fp, Aa^Fp, Gs, Gs, Hh, Hh, Hh, Ha, Ms, Ms, Ms, Ms
Gs^Fp, Gs^Fp, Re, Gs^Fp, Aa^Fp, Aa^Fp, Gs^Fp, Gs^Fp, Gs^Fp, Gs, Gs, Aa, Aa^Fp, Gs^Fp, Gs^Fp, Gs^Fp, Gs^Fp, Gs, Re, Gs, Gs, Gll^Fmw, Gs, Gll^Fp, Gll^Fp, Gll^Fp, Gll^Fp, Gs, Gs^Es, Aa^Fma, Aa^Fp, Gs, Gg, Gg, Hh, Hh^Es, Hh, Ms, Ms, Ms, Ms, Ms
Gs^Fp, Gs^Fp, Re, Gs^Fp, Aa^Fp, Aa^Fp, Gg^Fet, Aa^Fp, Aa^Fp, Gs, Gs, Aa, Aa, Gs, Gs, Gs^Vc, Gs^Fp, Gs, Gs, Re, Gs, Gs, Gs, Gs, Gs, Gll^Fp, Gll^Fp, Gll^Fp, Gll^Fp, Aa^Fma, Aa^Fp, Gs, Hh, Hh, Hh^Es, Ha, Hh, Ms, Ms, Ms, Ms, Ms
Gs^Fp, Gs^Vc, Aa^Fp, Re, Re, Aa^Fp, Gs^Fp, Gs^Fp, Aa^Fp, Gs^Fp, Gs, Gs, Aa^Fma, Aa^Fp, Gs, Gs^Fp, Gs^Fp, Gs^Fp, Gs, Re, Re, Gs, Gs, Gs, Gs, Gll^Fp, Aa^Fma, Hh, Gll^Fmw, Aa^Fp, Aa^Fp, Gs, Hh, Hh, Hh, Ha, Ha, Ms, Ms, Ms, Ms, Ms
Gs^Fp, Gg, Aa^Fp, Re, Re, Aa^Fp, Aa^Fp, Gs^Fp, Aa^Fpa, Aa, Aa^Fp, Aa^Fp, Aa^Fma, Aa^Fp, Gs, Gs^Fp, Gs^Fp, Gs^Fp, Gs, Gs, 1 Ke, Ce, Gd, Gs, Gs, Gs, Gll^Fma, Aa, Hh, Aa^Voa, Gll^Fp, Gs, Gs, Hh, Hh, Ha, Ha^Es, Ha, Ms, Ms, Ms, Ms
Gs^Fp, Gg, Aa^Fmw, Gll^Fmw, Re, Re, Gs^Fp, Aa^Fpa, Aa^Fpa, Aa, Aa^Fpa, Aa^Fma, Aa^Fma, Gs^Fp, Gs, Gs^Fp, Gs^Fp, Gs, Gs, Gs, Ce, Ce, Re, Gs, Gs, Gs, Gs, Aa^Fp, Aa^Fp, Hh, Gd^Em, Gs, Gs, Hh, Hh^Es, Hh, Ha, Ha, Mm, Ms, Ms, Ms
Aa^Fpa, Aa^Fpa, Aa^Fpa, Gs^Fp, Gs^Fp, Re, Re, Aa^Fpa, Aa, Aa, Aa^Fpa, Aa^Fp, Aa^Fp, Gs^Fp, Gs^Fp, Gs^Fp, Gs, Gs^Fp, Gd, Ce, Gd, Ce, Re, Gs, Gs, Gs, Gs, Gs, Hh, Hh, Gll^Fmw, Gs, Gs, Hh, Ha, Ha, Ha, Ha, Mm, Mm, Ms, Ms
Gs^Fp, Aa^Fpa, Aa^Fp, Aa^Fpa, Gs^Fp, Re, Re, Aa, Aa^Fp, Aa^Fmw, Aa^Fpa, Aa^Fpa, Aa, Aa^Fp, Aa^Fp, Aa^Fp, Gs, Gs, Gs^Fp, Gs, Gs, Gs, Gs, Re, Re, Gs, Gs, Gs, Gs^Es, Hh, Hh, Gs, Gs, Aa, Aa, Ha, Ha, Mm, Mm, Mm, Ms, Ms
Gs^Fp, Gs^Fmw, Gs^Fp, Aa^Fp, Aa^Fp, Gs^Fp, Re, Gs, Aa^Fp, Aa^Fpa, Aa^Fp, Aa^Fp, Aa^Fp, Aa^Vha, Aa, Aa^Fma, Gs, Gs^Fma, Gs^Fma, Gs^Fp, Gs, Gs, Gs, Gs^Es, Re, Re, Re, Gs, Gll^Fp, Hh, Hh, Hh, Gs, Gs, Aa, Ha, Hh^Es, Mm, Mm, Ms, Ms, Ms
Gs, Gs^Fp, Gs, Gd, Gd, Gs^Fp, Re, Gs^Fp, Aa^Fpa, Aa^Fp, Gll^Fmw, Aa^Fp, Aa^Fp, Aa, Aa, Aa^Fma, Aa^Fma, Gs^Fma, Gs^Fp, Gs^Fp, Gs^Fp, Gs, Gs^Esd, Gs, Re, Gs, Re, Gs, Gs, Gll^Fp, Gll^Fp, Gll^Fp, Gs, Gs, Gs, Hh, Hh, Hh, Hh, Mm, Ms, Ms
Gs, Gd, Gs^Fmw, Gs, Gs^Fp, Aa^Fp, Aa, Aa^Fpa, Aa^Fp, Gs^Fp, Gs, Gs, Gs, Aa^Fma, Aa, Aa, Aa, Gs, Gs, Gs^Vc, Gs^Fp, Gs, Gs, Re, Gs, Gs, Re, Gs, Gs, Gs, Gs, Gs, Gs, Gs^Es, Gd^Vhr, Gs, Gd, Hh, Gd, Hh, Ms, Ms
Gs, Gs^Fp, Gs, Gs, Gs, Aa^Vha, Aa^Fp, Aa, Re, Gd, Gs, Gs, Gs, Gs^Fma, Gs^Fma, Aa, Aa, Aa, Aa, Gs^Fp, Gs, Gs, Gs, Re, Re, Gs, Gs, Re, Re, Gs, Gs, Gs, Gs^Esd, Rd^Gvs, Rd^Gvs, Rd^Gvs, Rd^Gvs, Gd, Gs, Hh, Mm, Ms
Gs, Gd, Gs, Gs, Gs, Gs, Gll^Fmw, Gll^Fmw, Re, Gll^Fmw, Gs, Gs, Gs^Fp, Gs^Fp, Gs, Aa, Aa, Aa, Aa, Aa, Aa, Gs, Gs, Gs, Re, Gs^Es, Gs, Gs, Gs, Gs, Rd^Gvs, Gs^Es, Re^Gvs, Re^Gvs, Re^Gvs, Rd^Gvs, Gs^Eff, Gd^Eff, Hh, Hh, Ms, Ms
Gs, Gs, Gs, Gs, Gs, Gs^Vc, Gs, Re^Es, Re, Gd, Gs, Gs, Gs, Gs, Aa, Aa, Aa, Aa, Aa, Aa, Aa, Gs, Gs, Gs, Gs, Re, Gs, Gs, Gs, Gd^Eff, Gd^Eff, Rd^Gvs, Rd^Gvs, Re^Gvs, Gs^Eff, Gs, Hh, Hh, Hh, Ha, Ha, Hh
Aa, Aa, Aa, Aa, Aa, Aa, Aa, Gs, Re, Gll^Fmw, Gs, Gs, Gs, Aa, Aa, Aa, Aa, Aa, Aa, Aa, Aa, Aa, Gs, Gs, Re, Re, Re, Gs, Gd, Gs, Gs, Gd^Eff, Gs, Gd^Eff, Gg, Gs, Gg, Hh, Gg, Hh, Hh, Ha
