Aa^Fpa, Aa^Fpa, Aa^Fpa, Aa^Fp, Gll^Fp, Ha, Ms, Ms, Ms, Ha, Gll^Fp, Gll^Fp, Gll^Fp, Gll^Fmw, Gs, Gll^Fp, Gs, Gs, Gs, Gs, Aa, Gll^Fp, Gll^Fp, Hh, Gll^Fp, Gll^Fp, Hh, Mm, Ms, Ms
Aa^Fp, Aa^Fp, Aa^Fp, Aa^Fmw, Aa^Fp, Ha, Mm, Ms, Ha, Ha, Ha, Hh, Hh, Gll^Fmw, Gll^Fp, Gll^Fp, Gs, Gs, Re, Aa, Aa, Aa, Aa^Fpa, Hh, Gll^Fp, Hh, Mm, Mm, Ms, Ms
Gll^Fp, Gll^Fp, Ha, Aa^Fmw, Aa^Fp, Hh, Hh, Hh, Hh^Es, Gll^Fp, Gll^Fp, Hh, Hh, Gll^Fp, Gll^Fp, Gs^Em, Gll^Fp, Gs^Es, Gs, Aa, Aa^Fp, Aa^Fpa, Aa^Fpa, Aa^Fpa, Gll^Edb, Hh, Hh, Mm, Ms, Ms
Ha, Ha, Aa^Fp, Aa^Fp, Aa^Fmw, Gll^Fp, Ha, Ha, Ha, Hh, Gll^Fp, Gll^Fp, Gll^Fp, Gll^Fp, Gll^Fmw, Gll^Fp, Gll^Fmw, Gs, Re, Aa, Aa^Fp, Aa^Fp, Aa^Fmw, Gll^Fp, Gll^Fp, Gs^Em, Hh, Hh, Ms, Ms
Hh, Aa^Fp, Aa^Fmw, Aa^Fmw, Aa^Fp, Gll^Fp, Gll^Fp, Gll^Fp, Gll^Fp, Hh, Gll^Fp, Gll^Fp, Aa^Fmw, Gll^Fmw, Gll^Fp, Gll^Fmw, Gs, Gs, Aa, Aa, Gll^Em, Gll^Fp, Gll^Fmw, Aa^Fp, Gll^Fp, Hh, Hh, Hh, Mm, Ms
Hh, Aa^Fp, Aa^Fp, Aa^Fmw, Gll^Edb, Gs, Gs, Gll^Em, Gll^Fp, Hh, Gll^Fp, Gll^Fp, Aa^Fp, Gll^Fp, Aa, Gs, Re, Re, Aa, Aa, Aa^Fpa, Gll^Fmw, Gll, Gll^Fp, Gll, Hh^Es, Hh, Mm, Ms, Ms
Gll^Fp, Aa^Fp, Aa^Fp, Aa^Fp, Gs, Gll^Fp, Gll^Fp, Gll^Fmw, Gll^Fp, Gll^Fp, Gll^Fp, Gll^Fmw, Aa^Fp, Gll^Fp, Gs^Es, Gs, Gs, Aa, Aa^Fpa, Aa^Fpa, Aa^Fp, Aa^Fp, Aa^Fpa, Gll^Fp, Gll, Hh, Hh, Mm, Ms, Ms
Aa^Fpa, Aa^Fpa, Aa^Fmw, Gll, Gll^Fp, Gll^Fp, Gll^Fp, Gll, Gll^Fp, Gll^Fp, Gll^Fmw, Gll^Fp, Aa, Aa^Fp, Aa, Gs, Gs, Aa^Fpa, Aa^Fp, Aa^Fp, Aa^Fp, Aa^Fpa, Gs^Em, Gs, Gs, Gs, Hh^Es, Hh, Hh, Ms
Aa^Fpa, Aa^Fp, Gll^Fp, Gs, Gll^Fp, Gll^Fp, Gs, Gll^Fp, Gs, Gll^Fp, Aa^Fp, Aa, Aa, Aa, Aa, Aa, Aa, Aa^Fp, Aa^Fp, Gll, Aa^Fp, Aa^Fpa, Gll^Fp, Hh, Hh, Hh, Hh, Hh, Hh, Hh
Gs, Gll^Em, Aa, Gs, Gll^Fp, Gll, Gll^Fp, Gs, Gs, Gll^Fmw, Aa, Aa, Gs, Gs, Re, Aa, Aa^Fp, Aa^Fp, Aa^Fp, Aa^Fp, Hh, Aa^Fpa, Hh, Gll^Fp, Hh^Es, Hh, Ms, Ms, Ms, Mm
Gs, Gs, Gs, Gs, Gs, Gs, Gs, Gs, Re, Gs, Gs^Es, Gs, Re, Re, Gs, Aa, Aa^Fp, Hh, Hh, Aa^Fp, Gll^Fp, Aa^Fp, Aa^Fp, Aa^Fpa, Aa^Fpa, Ha, Ms, Ms, Ms, Ms
Gs, Gs, Re, Re, Gs, Re, Re, Re, Gs, Re, Re, Re, 1 Re, Gs^Es, Aa, Gll^Fp, Aa^Fp, Hh, Aa, Aa, Aa^Fp, Gll^Fp, Aa^Fp, Aa^Fpa, Aa^Fp, Ha, Ha, Ms, Ms, Ms
Gll, Gs, Hh, Gll^Fp, Gll^Fp, Gs, Gs, Gs, Gs, Gs, Gll^Fp, Re, Gs, Re, Aa, Aa^Fp, Aa^Fp, Aa, Aa^Fp, Aa^Fp, Gs, Aa, Aa, Aa^Fp, Gll^Fmw, Gll^Fp, Ha, Mm, Mm, Ms
Hh, Hh, Hh, Gll^Fp, Ww, Gs^Es, Aa^Fmw, Gs, Gs, Gs, Gs, Gll^Fp, Gs, Re, Aa, Aa, Gs, Aa^Fmw, Aa^Fp, Gll, Gs, Gs, Ha, Gll, Hh, Gll^Fp, Ha, Ha, Mm, Mm
Mm, Mm, Hh, Hh, Ww, Ai, Aa^Fmw, Gs, Gs, Gs, Aa^Fp, Gs, Gs, Aa, Aa, Gs, Gs, Aa^Fmw, Gs, Gs, Gs, Hh^Es, Ha, Ha, Hh, Gll^Fp, Gll^Fp, Ha, Ms, Ms
Mm, Mm, Ha, Wwr, Ww, Aa^Fpa, Aa, Gs, Gll^Fp, Gll^Fp, Aa^Fp, Aa^Fp, Aa^Fp, Aa^Fp, Aa, Re, Re, Gs, Gs, Gs, Gs, Ha, Ms, Ms, Ms, Gll^Fp, Ha, Ms, Ms, Ms
Ha, Mm, Wwr, Ww, Ww, Aa^Efm, Aa, Aa, Gs, Gll^Fp, Aa^Fmw, Aa^Fp, Aa^Fp, Aa, Gs, Gs, Gs, Re, Gs^Es, Gs, Gs, Ha, Ms, Ms, Ms, Hh, Hh, Ms, Ms, Ms
Ha, Ha, Ww, Ww, Ww, Ai, Aa, Aa^Fp, Gll^Fp, Gll^Fp, Gll^Fp, Aa^Fpa, Aa^Fpa, Gll^Fp, Gll^Fp, Gs, Gs, Re, Aa, Gs, Aa^Fp, Ha, Ms, Ms, Ms, Hh, Hh^Es, Mm, Mm, Ms
Aa^Fp, Ww, Ww, Ww, Ai, Aa, Aa, Gll^Fp, Gll^Fp, Gs^Em, Gll, Aa^Fp, Aa^Fp, Aa, Aa^Fp, Gs, Gs, Re, Aa, Aa, Aa^Fmw, Ha, Ha, Ms, Ha, Ha, Ha, Mm, Mm, Mm
Aa^Fp, Ww, Aa, Aa, Aa, Aa, Aa^Fpa, Aa^Fp, Aa^Fp, Gll^Fp, Gll^Fp, Aa^Fp, Aa^Fp, Aa, Aa^Fp, Gll^Fp, Gs^Es, Re, Aa, Aa, Aa^Fmw, Aa^Fp, Aa^Fp, Ha, Aa^Fpa, Ha, Ha, Hh, Mm, Mm
Aa, Aa^Es, Aa, Aa, Aa, Aa^Es, Aa^Fpa, Aa^Fpa, Aa^Fmw, Gll^Fp, Gll^Fp, Gll^Fp, Gs, Aa^Fp, Gs, Gs, Gs, Re, Aa^Fp, Aa, Aa^Fp, Aa^Fp, Aa^Fp, Aa^Fpa, Aa^Fpa, Aa^Fp, Gll^Fp, Hh, Hh^Es, Mm
Aa^Fp, Aa, Aa^Fp, Aa^Fpa, Aa^Fp, Aa^Fp, Aa^Fpa, Aa^Fpa, Aa^Fp, Gll^Fp, Gll^Fp, Gs^Es, Aa, Gs, Gs, Re, Aa, Gll^Fp, Gll^Fp, Aa^Fp, Aa^Fp, Gll^Fp, Aa^Fp, Aa^Fp, Aa^Fp, Aa^Fp, Gll^Fp, Hh, Hh, Hh
Aa^Fp, Aa^Fmw, Aa^Fp, Aa^Fp, Aa^Fpa, Aa^Fpa, Aa, Aa^Fp, Gll^Fp, Gll^Fp, Gll^Fp, Aa, Aa, Aa, Gs, Re, Re, Gll^Fp, Gs, Gll^Fp, Gs, Aa^Fp, Aa^Fp, Aa^Fp, Aa^Fp, Gs^Em, Hh, Hh, Mm, Mm
