Mm, Mm, Mm, Hh, Gs^Fp, Gg, Wwg, Gg, Gg, Gg, Gs^Efm, Gs, Gs^Efm, Gs, Gs^Efm, Gg, Gg^Efm, Gg^Efm, Gg, Gg, Gg, Gs, Gs^Fp, Gs^Fp, Hh, Gs^Fp, Gs^Fp, Gs^Fp, Hh, Gll^Fp, Hh, Hh, Hh, Hh, Hh
Mm, Mm, Hh^Fp, Hh^Fp, Gs^Fp, Gs^Fp, Wwg, Gg^Fp, Gs^Fp, Gg, Gg, Gs^Efm, Gg, Gs^Efm, Gg, Gs^Efm, Gg, Gs^Efm, Gg, Gll^Fp, Gd, Gs, Gs^Fp, Hh^Fp, Hh^Fp, Hh, Hh, Hh, Gs^Fp, Hh^Efm, Gg, Gg^Efm, Gg, Gg, Gs
Hh, Mm, Hh^Fp, Hh^Fp, Gg^Fp, Gs^Fp, Gs^Fp, Wwg, Gg^Efm, Gs^Fp, Gs^Fp, Gg, Gs, Gs^Fp, Gs^Fp, Gg, Gs^Fp, Gg, Gs^Fp, Gg, Gg, Gg, Gg^Fp, Hh^Fp, Gg^Fp, Hh^Fp, Hh, Hh, Gg, Gg^Efm, Gd, Gs, Gg, Gs^Fp, Gs
Hh, Hh^Fp, Hh^Fp, Hh^Fp, Hh^Fp, Gs^Fp, Gs^Fp, Wwg, Wwg, Gs^Fp, Gs^Fp, Gs^Fp, Gs^Fp, Gs^Fp, Gs^Fp, Gs^Fp, Gs^Fp, Gs^Fp, Gs^Fp, Gs, 3 Re, Gs, Gg, Gs^Fp, Hh^Fp, Hh^Fp, Hh^Fp, Hh^Efm, Gg, Gs, Gg, Gg, Gs^Fp, Gs^Fp, Gs^Fp
Hh, Hh^Fp, Hh^Fp, Hh^Fp, Hh^Fp, Hh^Fp, Hh^Fp, Wwg, Hh^Fp, Hh^Fp, Gs^Fp, Gs^Fp, Gs^Fp, Gs, Gs^Fp, Gs^Fp, Gs^Fp, Gs^Fp, Gs^Fp, Gd, Re, Re, Gs, Gs^Fp, Hh^Fp, Hh^Fp, Gs^Fp, Gs^Fp, Gg, Gs^Fp, Hh^Fp, Gs^Fp, Gs^Fp, Hh^Fp, Hh^Fp
Hh, Hh^Fp, Gs, Gs^Fp, Gs^Fp, Hh^Fp, Wwg, Wwg, Gg^Fp, Gs^Fp, Gs^Fp, Gs^Fp, Gg, Gs^Fp, Gg, Gs^Fp, Gg, Gg, Gs, Gg, Gg, Gg, Gs^Fp, Gs^Fp, Hh^Fp, Hh^Fp, Gs^Fp, Gs^Fp, Gg, Hh, Gs^Fp, Hh^Fp, Hh^Fp, Hh^Fp, Hh^Fp
Hh^Fp, Gg^Fp, Gs^Fp, Gs^Efm, Gs, Gs^Fp, Wwg, Gs^Fp, Gg^Fp, Gs^Fp, Gg, Gg, Gll^Fp, Gg, Gg, Gs^Fp, Gg, Gs^Fp, Gs^Fp, Gs^Fp, Gs^Fp, Gg, Gs^Fp, Gs^Fp, Hh^Fp, Hh^Fp, Gs^Fp, Gg, Gs, Gg, Gs^Fp, Gs^Fp, Gs^Fp, Hh^Fp, Hh^Fp
Gg, Hh^Fp, Gs^Fp, Gs^Fp, Gs^Fp, Gg, Gs^Fp, Wwg, Wwg, Gs^Fp, Gg, Gll^Fp, Gll^Fp, Hh, Gs^Fp, Gg, Gll^Fp, Gg^Fp, Gll^Fp, Gll^Fp, Gs, Gs, Gg, Gs^Fp, Gs^Fp, Gs^Fp, Gs^Fp, Gs^Fp, Gs, Gs, Gs, Gs^Fp, Gs^Fp, Gs^Fp, Gs^Fp
Gs^Fp, Hh, Gs^Fp, Gs^Fp, Gs^Fp, Gs, Gg^Fp, Gg, Gd, Wwg, Wwg, Gg^Efm, Hh^Efm, Hh, Mm, Gs^Fp, Gg^Fp, Gll^Fp, Gg, Gg, Gs^Fp, Gs, Gs^Fp, Gs^Fp, Gs^Fp, Gs^Fp, Gs^Fp, Gs^Fp, Gg, Gs^Efm, Gs, 2 Gg, Gs^Fp, Gs^Fp, Gg
Gs^Fp, Gs^Fp, Gs^Fp, Gg, Gs^Fp, Gg, Gs^Fp, Gs^Fp, Gs, Gd, Gg, Wwg, Gll^Fp, Hh, Mm, Hh^Fp, Hh^Fp, Gll^Fp, Gg^Efm, Gll^Fp, Gs, Gg^Fp, Gs^Fp, Gs^Fp, Gs^Fp, Gs^Fp, Gs^Fp, Gs^Fp, Gs^Fp, Gs^Fp, Gg, Gs, Gs, Gg, Gg
Gs^Fp, Gs^Fp, Gg^Fp, Gg, Gg^Fp, Gs^Fp, Gs^Fp, Gg, Gs, Gs, Wwg, Wwg, Gll^Fp, Hh, Hh, Mm, Mm, Hh^Fp, Hh^Fp, Gg, Gs^Fp, Gg, Gs, Gs^Fp, Gs^Fp, Gs^Fp, Gg, Gg, Gg, Gs^Fp, Gs^Fp, Gg^Efm, Gs, Gs^Efm, Gs
Gs^Fp, Gs^Fp, Gs^Fp, Gs^Fp, Gs^Fp, Gs^Fp, Gs^Fp, Gs^Fp, Wwg, Wwg, Gll^Fp, Gg, Hh, Hh, Gs, Gs^Fp, Gs^Fp, Hh, Gs^Fp, Hh, Gs^Fp, Gs^Fp, Gs, Gs^Fp, Gs^Fp, Gs^Fp, Gs^Fp, Gs, Gg, Gs^Fp, Gs^Fp, Gs^Fp, Gs^Fp, Gs, Gg
Gs^Fp, Gs^Fp, Gs^Fp, Hh^Fp, Hh^Fp, Gs^Fp, Gs^Fp, Gg, Wwg, Gll^Fp, Gll^Fp, Gll^Fp, Gg, Gs^Fp, Gs^Fp, Gs^Fp, Gs^Fp, Gs^Fp, Gg, Gs^Fp, Gs^Fp, Gs^Fp, Gs^Fp, Gg, Gg, Gg, Gs, Gs, Gg, Gs^Fp, Gs^Fp, Gs^Fp, Gs^Fp, Gg, Gg
Gs^Fp, Gs^Fp, Hh^Fp, Hh^Fp, Hh^Fp, Gs^Fp, Gs^Fp, Gs^Efm, Gs^Fp, Wwg, Wwg, Wwg, Wwg, Gs^Fp, Gg, Gs^Fp, Gs^Fp, Gg, Gs^Fp, Gs, Gs, Gg, Gs, Gs, Gd, Gs, Gd, 1 Gs, Gs, Gs^Fp, Gs^Fp, Gs^Fp, Gs^Fp, Gg, Gg
Gs, Gs^Fp, Gs^Fp, Hh^Fp, Hh^Fp, Hh, Gs^Fp, Gs^Fp, Gs^Fp, Wwg, Gs, Gs^Fp, Wwg, Gg, Gg^Efm, Gg, Gg, Gg, Gs^Fp, Gs^Fp, Gg, Gs, Gg, Gs, Gs^Fp, Gg, Gg^Efm, Gs, Gg, Gs, Gg, Gs^Fp, Gg, Gg, Gg
Gs^Fp, Gs^Fp, Gs^Fp, Hh^Efm, Wwg, Gg^Fp, Hh^Fp, Hh^Fp, Wwg, Wwg, Gg, Gs^Fp, Gs^Fp, Wwg, Wwg, Gs^Fp, Gs, Gs^Fp, Gs^Fp, Gs^Fp, Gs^Fp, Gs^Fp, Gs^Fp, Gs^Fp, Gs^Fp, Gs^Fp, Gg, Gs^Fp, Gs^Fp, Gs^Fp, Gs^Fp, Gg, Gg, Gs^Fp, Gg
Gs^Fp, Gs^Fp, Wwg, Wwg, Wwg, Gs^Fp, Gs^Fp, Wwg, Gs^Fp, Gs^Fp, Hh, Gs^Fp, Hh, Hh, Wwg, Gs^Fp, Gg, Gs^Fp, Hh, Gs^Fp, Gs^Fp, Gs^Fp, Gs^Fp, Gs^Fp, Gs^Fp, Gs^Fp, Gs^Fp, Gs^Fp, Gs^Fp, Gs^Fp, Gs^Fp, Gs^Fp, Gs^Fp, Gs^Fp, Gg
Gs^Fp, Gs^Fp, Wwg, Wwg, Wwg, Wwg, Wwg, Wwg, Gg, Hh^Fp, Hh^Fp, Hh^Fp, Gs^Fp, Hh, Wwg, Gg, Gs^Fp, Gs^Fp, Hh, Hh^Fp, Hh, Gs^Fp, Hh^Fp, Gs^Fp, Gg, Gs^Fp, Gg, Gs^Fp, Gs^Fp, Gs^Fp, Gg, Gs^Fp, Gs^Fp, Gs^Fp, Gg
Gs^Fp, Gs^Fp, Wwg, Wwg, Wwg, Wwg, Wwg, Wwg, Gg, Hh^Fp, Hh, Hh^Fp, Gs^Fp, Gs^Fp, Gd, Wwg, Gs, Gs, Gs^Efm, Hh^Fp, Hh, Hh, Hh^Fp, Gs^Fp, Gs^Fp, Gs^Fp, Hh^Fp, Hh^Fp, Gs^Fp, Gg, Gs, Gs^Fp, Gs^Fp, Gg, Gs^Fp
Gg, Gg, Gs^Fp, Wwg, Gs^Fp, Wwg, Gs^Fp, Gg, Gg^Fp, Hh^Fp, Hh^Fp, Hh, Gs^Fp, Gs, Gs, Wwg, Gg, Gs^Efm, Gs^Fp, Hh^Fp, Hh^Fp, Hh^Fp, Hh^Fp, Hh^Fp, Hh^Fp, Hh^Fp, Gs^Fp, Hh^Fp, Hh^Fp, Gg, Gs^Fp, Gs, Gg, Gs^Fp, Gs^Fp
Gll^Fp, Hh, Hh, Gs^Fp, Gs, Gs^Fp, Gs, Gs^Fp, Gg, Hh^Fp, Hh^Fp, Hh^Fp, Gs^Fp, Gg, Gg, Wwg, Wwg, Gs^Fp, Gs, Hh^Fp, Hh, Hh^Fp, Mm, Mm, Mm, Mm, Mm, Hh, Hh^Fp, Hh^Fp, Hh, Hh^Fp, Gs^Fp, Gs^Fp, Gs^Fp
