Gll^Fp, Gll^Fp, Gll^Fp, Gll^Fp, Gll^Fp, Gll^Fp, Gll^Fp, Gs, Gll^Fp, Re, Gll^Fp, Gll^Fp, Gll^Fp, Gll^Fp, Gll^Fp, Gll^Fp, Gll^Fp, Gll^Fp, Gll^Fp, Gll^Fp, Gll^Fp, Gll^Fp, Gll^Fp, Gll^Fp, Gll^Fp, Gll^Fp, Gll^Fp, Gll^Fp, Gll^Fp, Gll^Fp, Gll^Fp, Gll^Fp
Gg, Gll^Fp, Gll^Fp, Gll^Fp, Gll^Fp, Gll^Fp, Gll^Fp, Gll^Fp, Gll^Fp, Re, Re, Gll^Fp, Gll^Fp, Gll^Fp, Gll^Fp, Gll^Fp, Gll^Fp, Gll^Fp, Gll^Fp, Gll^Fp, Gll^Fp, Gll^Fp, Gll^Fp, Gll^Fp, Gll^Fp, Gll^Fp, Gll^Fp, Gll^Fp, Gll^Fp, Gll^Fp, Gll^Fp, Gll^Fp
Gg, Gg^Efm, Ww, Gll^Fp, Ww, Gll^Fp, Gll^Fp, Gll^Fp, Gll^Fp, Gll^Fp, Gll^Fp, Re, Gll^Fp, Gll^Fp, Gll, Gll, Gll, Gll, Gll, Gll^Fp, Gll^Fp, Gll^Fp, Gll^Fp, Gll^Fp, Gs, Gs, Gs, Gll^Fp, Gs, Gll^Fp, Re, Re
Gg, Gg, Gg^Efm, Ww, Ww, Gg^Efm, Gll^Fp, Gll^Fp, Gll^Fp, Gll^Fp, Gll^Fp, Re, Re, Gll, Gs, Gll, Gll, Gll, Gll, Gll, Gll^Fp, Gll^Fp, Gs, Gs, Re, Re, Re, Gs, Re, Re, Gs, Gs
Gg, Gg, Ww, Ww, Ww, Ww, Gll^Fp, Gll^Fp, Gll^Fp, Gll^Fp, Gll^Fp, Gll^Fp, Gs, Re, Re, Gs, Gll, Gll, Gll, Gll, Gll, Gs, Re, Re, Gll^Fp, Gs, Gs, Re, Gs, Gs, Gll^Fp, Gll^Fp
Gg, Ww, Ww, Ww, Ww, Ww, Gg, Gll^Fp, Gll^Fp, Gll^Fp, Gll^Fp, Gll^Fp, Gll^Fp, Gs, Re, Gs, 1 Gs, Gll, Gs, Gs, Re, Re, Gs, Gll^Fp, Gll^Fp, Gll^Fp, Gll^Fp, Gs, Gll^Fp, Gll^Fp, Gll^Fp, Gll^Fp
Gll^Fp, Gg, Ww, Ww, Gg, Ww, Gg, Gll^Fp, Gll^Fp, Gll^Fp, Gll^Fp, Gll^Fp, Gll, Gs, Gs, Re, Re, Gs, Re, Re, Gs, Gs, Gs, Gs, Gll^Fp, Gll^Fp, Gll^Fp, Gll^Fp, Hh, Hh, Hh, Gll^Fp
Gll^Fp, Gg, Gg, Gg, Gll^Fp, Gg, Gs, Gll^Fp, Gs, Gll^Fp, Gll^Fp, Gll^Fp, Gll^Fp, Gll, Gs, Re, Gs, Re, Gs, 2 Gs, Gs, Gs, Gs, Gs, Gs, Gs, Gll^Fp, Hh, Hh, Hh, Hh, Hh
Gll^Fp, Gll^Fp, Gll^Fp, Gll^Fp, Gll^Fp, Gll^Fp, Gs, Gll^Fp, Gll^Fp, Gll^Fp, Gll^Fp, Gll^Fp, Gs, Gs, Re, Re, Gs, Gs, Gs, Gs, Gll^Fp, Gll^Fp, Gll^Fp, Gs, Gs, Gs, Gs, Gll^Fp, Hh, Hh, Hh, Hh
Gll^Fp, Gs, Gll^Fp, Gll^Fp, Gll^Fp, Gll^Fp, Gll^Fp, Gs, Gll^Fp, Gll^Fp, Gll^Fp, Gll, Gs, Re, Gs, Gs, Gll^Fp, Gs, Gs, Gs, Gll^Fp, Hh, Hh, Gll^Fp, Gll^Fp, Gll^Fp, Gll^Fp, Gll^Fp, Hh, Hh, Mm, Mm
Gll^Fp, Gll^Fp, Gll^Fp, Gll^Fp, Gll^Fp, Gll^Fp, Gll^Fp, Gs, Gs, Gll^Fp, Gs, Gs, Re, Re, Gs, Gll, Gll^Fp, Gll^Fp, Gll^Fp, Gs, Gll^Fp, Hh, Hh, Gll^Fp, Hh, Hh, Hh, Hh, Hh, Mm, Mm, Mm
Gll^Fp, Gll^Fp, Gll^Fp, Gll^Fp, Gll^Fp, Gll^Fp, Gll^Fp, Gs, Gs, Gs, Re, Re, Gs, Gs, Gll^Fp, Gll, Gll^Fp, Hh, Hh, Gll^Fp, Gll^Fp, Hh, Mm, Hh, Mm, Mm, Mm, Hh, Hh, Mm, Mm, Mm
Gll^Fp, Gll^Fp, Gll^Fp, Gll^Fp, Gll^Fp, Gll^Fp, Gs, Gs, Re, Re, Gs, Gs, Gs, Gll^Fp, Hh, Gll^Fp, Hh, Hh, Hh, Gll^Fp, Gll^Fp, Hh, Hh, Mm, Mm, Mm, Mm, Mm, Mm, Mm, Mm, Mm
Gs, Gll^Fp, Gll^Fp, Gll^Fp, Gs, Gs, Re, Re, Gs, Gs, Gll^Fp, Gll^Fp, Gll^Fp, Gll^Fp, Hh, Hh, Hh, Hh, Hh, Hh, Hh, Hh, Mm, Mm, Mm, Mm, Mm, Mm, Mm, Mm, Mm, Mm
Gs, Gs, Gs, Gs, Re, Re, Gs, Gs, Gll^Fp, Gll^Fp, Gll^Fp, Gll^Fp, Gll^Fp, Gll^Fp, Hh, Hh, Hh, Hh, Hh, Hh, Hh, Mm, Mm, Mm, Mm, Mm, Mm, Mm, Mm, Mm, Mm, Mm
Gs, Gs, Re, Re, Gs, Gs, Gll^Fp, Gll^Fp, Gll^Fp, Gll^Fp, Gll^Fp, Gll^Fp, Gs^Fp, Gs^Fp, Gs^Fp, Hh, Hh, Hh, Gll^Fp, Gll^Fp, Gll^Fp, Gll^Fp, Mm, Mm, Mm, Mm, Mm, Mm, Mm, Mm, Mm, Mm
Re, Re, Gs, Gs, Gll^Fp, Gll^Fp, Gll^Fp, Gll^Fp, Ds, Gll^Fp, Gll^Fp, Gll^Fp, Gs^Fp, Gll^Fp, Gll^Fp, Hh, Hh, Gll^Fp, Gll^Fp, Gll^Fp, Mm, Mm, Gll^Fp, Mm, Mm, Mm, Mm, Mm, Mm, Mm, Mm, Mm
