Gs^Fp, Gs^Fp, Gs^Fp, Gg^Fp, Gg^Fms, Gg^Fp, Gg^Fp, Wwg, Gg^Fp, Gs^Fp, Gs^Fp, Gs^Fp, Gs^Fp, Gs^Fp, Gs^Fp, Gs^Fp, Gs^Fp, Gs^Fp, Gs^Fp, Gs^Fp, Gs^Fp, Gs^Fp, Hh^Fp, Gs^Fp, Hh^Fp, Gs^Fp, Mm, Mm, Mm, Mm, Mm, Mm
Gg, Gs^Fp, Gg^Fp, Gg^Fp, Wwg, Wwg, Wwg, Wwg, Gg^Fp, Gs^Fp, Gs^Fp, Gs^Fp, Gs^Fp, Gs^Fp, Gll^Fp, Gs^Fp, Gs^Fp, Gs^Fp, Gs^Fp, Hh^Fp, Hh^Fp, Hh^Fp, Mm, Mm, Mm, Mm, Mm, Mm, Mm, Mm, Mm, Mm
Gg, Gg^Efm, Wwr, Gg^Fp, Ww, Gg^Fp, Gg^Fp, Gg^Fp, Gg^Fms, Gs^Fp, Gs^Fp, Gs^Fp, Gll^Fp, Gll^Fp, Gll^Edt, Gll^Fp, Gll^Fp, Gs^Fp, Hh^Fp, Hh^Fp, Hh^Fp, Gs^Fp, Gs^Fp, Mm, Hh, Hh, Hh, Mm, Mm, Mm, Hh^Fp, Gs^Fp
Gg, Gg, Gg^Efm, Ww, Ww, Gg^Efm, Gg^Fp, Gs^Fp, Gs^Fp, Gs^Fp, Gs^Fp, Gs^Fp, Gll, Gs, Gll^Es, Gll, Gll^Fp, Gs^Fp, Hh^Fp, Hh^Fp, Hh^Fp, Hh, Hh, Hh, Hh, 2 Hh, Hh, Hh, Hh, Mm, Mm, Gs^Fp
Gg, Gg^Es, Ww, Ww, Ww, Ww, Gg^Fp, Gs^Fp, Gs^Fp, Gs^Fp, Gs^Fp, Gll^Fp, Gll, Gd, 1 Re, Gll, Gs, Gll^Fp, Gll^Fp, Gs^Fp, Hh^Fp, Hh, Hh, Hh, Gs^Es, Hh, Hh, Gs^Es, Gs^Es, Mm, Mm, Mm
Gg, Wwr, Ww, Ww, Ww, Ww, Gg, Gs^Fp, Gs^Fms, Gs^Fp, Gs^Fp, Gll^Fp, Gll^Fp, Gs, Re, Gd, Gll^Edt, Gll, Gll^Edt, Gs^Fp, Gs^Fp, Hh^Fp, Gs^Fp, Gs^Fp, Gs^Fp, Hh, Hh, Hh, Hh, Hh, Mm, Mm
Gs^Fp, Gg, Ww, Ww, Gg, Wwr, Gg, Gs^Fp, Gs^Fp, Gs^Fp, Gs^Fp, Gs^Fp, Gll, Gll, Re, Re, Re, 3 Gll, Gll, Gll^Fp, Gll^Fp, Gs^Fp, Gs^Fp, Gs^Fp, Gs^Fp, Hh, Gs^Fp, Hh, Gs^Fp, Hh, Hh^Fp, Gs^Fp
Gs^Fp, Gg, Gg, Gg, Gs^Fp, Gg, Gs^Fp, Gs^Fp, Gs, Gs^Fp, Gs^Fp, Gll^Fp, Gll^Fp, Gll^Edt, Re, Re, Gd, Gs, Gll, Gs, Gll, Gll^Edt, Gll^Fp, Gs^Fp, Gs^Fp, Gs^Fp, Hh, Gs^Fp, Gs^Fp, Hh^Fp, Hh, Mm
Gs^Fp, Gs^Fp, Gs^Fp, Gs^Fp, Gs^Fp, Gs^Fp, Re, Gs^Fp, Gs^Fp, Gs^Fp, Gs^Fp, Gll^Fp, Gll^Edt, Gs, Re, Gll, Gll^Fp, Gll^Fp, Gll^Fp, Gll^Edt, Gll, Gll^Es, Gll, Gll^Fp, Hh, Hh^Es, Hh, Hh, Hh, Hh^Es, Mm, Mm
Re, Re, Re, Re, Re, Re, Gs^Fp, Re, Gs^Fp, Gs^Fp, Gs^Fp, Gll^Fp, Gll^Fp, Re, Gll^Fp, Gll^Edt, Gll^Fp, Hh^Fp, Hh^Fp, Gll^Fp, Gs^Fp, Gll^Fp, Gs^Fp, Gs^Fp, Hh, Hh, Mm, Mm, Hh, Mm, Mm, Mm
Gs^Fp, Gs^Fp, Gs^Fp, Gs^Fms, Gs^Fp, Gs^Fp, Gs^Fp, Re, Re, Gs^Fp, Re, Re, Re, Re, Gll^Fp, Gll^Fp, Gs^Fp, Hh, Hh^Fp, Gs^Fp, Hh, Hh, Hh, Hh^Fms, Hh^Es, Mm, Mm, Mm, Hh^Es, Mm, Mm, Mm
Gs^Fp, Gs^Fp, Gs^Fms, Gs^Fp, Gs^Fp, Gs^Fp, Gs^Fp, Gs^Fp, Re, Re, Gs^Fp, Gs^Fp, Gs^Fp, Gs^Fp, Hh, Gs^Fp, Gs^Fp, Hh^Fp, Mm, Hh, Mm, Mm, Mm, Hh, Hh, Mm, Mm, Mm, Hh, Mm, Mm, Mm
Gs^Fp, Gs^Fp, Gs^Fp, Gs^Fp, Gs^Fp, Gs^Fp, Gs^Fp, Gs^Fp, Re, Gs^Fp, Gs^Fp, Gs^Fp, Gs^Fp, Gs^Fp, Hh^Fp, Gs^Fp, Gs^Fp, Hh, Hh, Mm, Mm, Mm, Mm, Mm, Mm, Mm, Mm, Mm, Mm, Mm, Mm, Mm
Gs, Gs^Fp, Gs^Fp, Gs^Fp, Gs^Fp, Gs^Fp, Gs^Fp, Gs^Fp, Re, Gs^Fp, Gs^Fp, Gs^Fp, Gs^Fp, Gs^Fp, Hh^Fms, Hh, Hh, Hh^Es, Mm, Mm, Mm, Mm, Mm, Mm, Mm, Mm, Mm, Mm, Mm, Mm, Mm, Mm
Gs^Fp, Gs^Fp, Gs^Fp, Gs^Fp, Re, Gs^Fp, Re, Re, Gll^Fp, Gll^Fp, Gs^Fp, Gs^Fp, Gs^Fp, Gs^Fp, Hh, Hh, Hh, Mm, Mm, Mm, Mm, Mm, Mm, Mm, Mm, Mm, Mm, Mm, Mm, Mm, Mm, Mm
Gs^Fp, Gs^Fp, Gs^Fp, Re, Gs^Fp, Re, Gs^Fp, Gs^Fp, Gs^Fp, Gs^Fp, Gs^Fp, Gs^Fp, Gs^Fp, Gs^Fp, Gs^Fp, Hh, Hh, Hh, Mm, Mm, Mm, Mm, Mm, Mm, Mm, Mm, Mm, Mm, Mm, Mm, Mm, Mm
Re, Gs^Fp, Gs^Fp, Re, Gs^Fp, Gs^Fp, Gs^Fp, Gs^Fp, Ds^Fp, Gs^Fp, Gs^Fp, Gs^Fp, Gs^Fp, Gll^Fp, Gll^Fp, Hh, Mm, Mm, Gll^Fp, Mm, Mm, Mm, Mm, Mm, Mm, Mm, Mm, Mm, Mm, Mm, Mm, Mm
