Mm, Mm, Mm, Mm, Mm, Mm, Hh, Hh, Hh, Hh, Hh, Hh, Hh, Gs^Fp, Gs^Fp, Gg, Gg, Wwg, Wwf, Gs^Fp, Gs^Fp, Gs^Fp, Gs^Fp, Gg, Gs^Fp, Gg, Gg, Gg, Gg, Gg, Gg
Mm, Mm, Mm, Mm, Mm, Mm, Hh, Hh, Gs^Fp, Gs^Fp, Gs^Fp, Hh, Gs^Fp, Gs^Fp, Gg^Efm, Gg^Efm, Gs, Wwf, Wwg, Wwf, Wwrg, Wwf, Wwrg, Gg, Gs, Gg, Gg^Efm, Re, Re, Re, Gg
Mm, Mm, Hh, Mm, Mm, Mm, Hh, Hh, Hh, Gg, Gg, Gs^Fp, Gg, Gs^Fp, Gg, Gs, Gd, Wwrg, Gs, Gs, Gs, Gd, Gs, Gd, Gg, Gg, Re, Re, Gg, Gg, Gg
Hh, Hh, Gg, Hh, Hh, Hh, Hh, Hh, Mm, Hh, Hh, Gg, Gg, Gs, Gs, Gs, Gs, Gd, Gs, Gs, Gg^Efm, Gs^Efm, Gg, Gg, Gs, Re, Gg, Gg, Gd, Gs^Fp, Gg
Re, Re, Hh, Re, Re, Hh, Hh, Mm, Mm, Mm, Hh, Gs^Fp, Gg, Gg, Gg, Gs, Gg, Gs, Gs, Gs, Gs, Gg, Re, Re, Gg, Gg, Gs, Gg, Gs^Fp, Gs^Fp, Gg
Gg, Gs, Mm, Hh, Hh, Gd, Gs, Mm, Mm, Mm, Hh, Gs^Fp, Gg, Gg, Re, Gs, Re, Gg, Re, Re, Gs, Gs, Gg, Re, Gg, Gs, Gd^Efm, Gg, Gs^Fp, Gs^Fp, Gg
Mm, Mm, Mm, Mm, Hh, Hh, Re, Hh, Hh, Hh, Gg, Gg, Re, Re, Gg, Gg, Gs, Re, Gs, Gs, Gs, Gs, Gg, Re, Gg, Gs, Gs, Gd, Gs^Fp, Gs^Fp, Gs^Fp
Mm, Mm, Mm, Mm, Hh, Hh, Hh, Re, Re, Re, Re, Gs, Gg, Gg, Gg, Gs, Gg, Gg, Gg, Gg, Gg, Gs, Gg^Efm, Re, Re, Gg, Gg, Gd, Gg, Gs^Fms, Gs^Fms
Mm, Mm, Hh, Hh, Hh, Hh, Gs^Fp, Gg, Gg, Gg, Gg, Gg, Gg, Gs^Fp, Gs^Fp, Gs^Fp, Gg, Gs^Fms, Gs^Fms, Gs^Fp, Gg, Gs, Gg, Gg^Efm, Re, Re, Gs, Gs, Gg, Gg, Gg
Mm, Hh, Hh, Hh, Hh, Hh, Hh, Gs^Fp, Gs^Fp, Gs^Fp, Gs^Fp, Gs^Fp, Gs^Fp, Gs^Fp, Gs^Fp, Gs^Fp, Gs^Fp, Gs^Fp, Gs^Fp, Gs^Fp, Gs^Fms, Gs^Fp, Gs^Fms, Gg, Gg, Re, Gg, Gs, Gg, Gs^Fms, Gll^Fp
Hh, Hh, Hh, Gs^Fp, Gs^Fp, Gs^Fp, Gs^Fp, Hh, Hh, Gs^Fp, Gs^Fp, Gs^Fp, Gll^Fp, Gs^Fp, Gll^Fp, Gs^Fp, Gll^Fp, Gs^Fp, Gs^Fp, Gs^Fp, Gs^Fp, Gs^Fp, Gg, Gg, Re, Re, Gg, Gs, Gll, Gll^Fp, Gll
Gs^Fp, Gs^Fp, Hh, Hh, Gs^Fp, Gs^Fp, Gll^Fp, Gs^Fp, Gs^Fp, Gs^Fp, Gs^Fp, Gs^Fp, Gll^Fp, Gll^Fp, Gll^Esd, Gll^Fp, Gll^Fp, Gs^Fp, Gll^Fp, Gs^Fp, Gs^Fp, Gs^Fp, Gg, Gg, Re, Gd, Gd, Gd, Gll^Esd, Gll^Edt, Gll
Hh, Gs^Fp, Gs^Fp, Gs^Fp, Gll^Fp, Gll^Fp, Gll^Fp, Gll^Fp, Gll^Fp, Gs^Fp, Gs^Fp, Gll^Fp, Gll^Fp, Gll^Edt, Gll, Gll, Gll^Edt, Gll^Es, Gll, Gll^Fp, Gg, Gg, Gd, Re, Gll, Gll, Gll, Gll^Fp, Gll^Fp, Gll^Es, Gll
Hh, Hh, Gs^Fp, Gll^Fp, Gll^Edt, Gll^Edt, Gll^Es, Gll^Edt, Gll, Gll^Fp, Gll^Fp, Gll^Fp, Gll, Gll, Gll^Es, Gll, Gll^Es, Gll^Edt, Gll, Gs, Gs, Gs, Re, Re, Gll^Edt, Gll^Es, Gll^Edt, Gll^Fp, Gll^Fp, Gll, Gll
Hh, Hh, Gll^Fp, Gll^Fp, Gll^Es, Gll^Esd, Gll^Edt, Gll, Gll, Gll^Fp, Gll, Gll, Re, Gll^Edt, Gll^Esd, Re, Gll, Gll, Gd, Gg^Fp, Gs, Gd, Re, Re, Re, Rb^Dr, Gll^Esd, Gll, Gll^Fp, Gll^Fp, Gll^Fp
Gs^Fp, Gs^Fp, Gs^Fp, Gll^Edt, Gll, Gll, Gll^Es, Gll, Gg^Fp, Gll^Es, Gll, Gll, Gll, Re, Re, Re, Gd, Re, Re^Edt, Gs, Gll, Re^Edt, Re, Re, Gd, Re, Gll^Es, Gll, Gll^Fp, Gs^Fp, Gs^Fp
Gs^Fp, Gs^Fp, Gg, Gg, Gg, Gll, Gll, Gll^Fp, Gg^Fp, Gll, Gll, Gll^Es, Gll, Gd, Gll, Re, Re, Re, Rb^Dr, Rb, Rb, Re, Re, Re, Gd, Gd, Gll, Gll, Gll^Fp, Gs^Fp, Gs^Fp
Gs^Fp, Gg, Gg^Efm, Gg^Efm, Gg, Gg, Gg^Efm, Gg, Gg^Efm, Gg, Gg, Gg, Gg, Gg, Gg, Gg, Gd, Re^Edt, Re, Re, Rb, Re, Re^Edt, Gs, Gg, Gd, Gll^Fp, Gll^Fp, Gs^Fp, Gs^Fp, Gs^Fp
Gs^Fp, Gs^Fp, Gs^Fp, Gs, Gs, Gs^Efm, Gs, Gg^Efm, Gs, Gg^Efm, Gs^Efm, Gg, Gs, Gs, Gg, Gg, Gs, Re, Co, Co, Rb^Dr, Cer, Re^Edt, Gs^Edt, Gg, Gg^Efm, Gll^Fp, Gll^Fp, Gs^Fp, Gs^Fp, Gs^Fp
Gs^Fp, Gs^Fp, Gs^Fp, Gs^Fp, Gs^Fp, Gs, Gs, Gd, Gs^Fp, Gd, Gd, Gs, Gg^Efm, Gg^Efm, Gs^Fp, Gg, Re, Re, Cer, Ket, Rb^Edt, Ce, Gd^Edt, Re, Re, Gs, Gg^Efm, Gs^Fp, Gs^Fp, Gs^Fp, Gs^Fp
Gs^Fp, Gs^Fp, Gs^Fp, Gs^Fp, Gs^Fp, Gs^Fp, Gs^Fp, Gg, Gs^Fp, Gg, Gg, Gg, Gd, Gd^Fp, Gs^Fp, Gg, Re, Re, Rb, Ce, Cer, Co, Gg, Gs, Re, Gg, Gg, Gs^Fp, Gs^Fp, Gs^Fp, Gs^Fp
Gs^Fp, Gs^Fp, Gs^Fp, Gs^Fp, Gs^Fp, Gs^Fp, Gs^Fp, Gs^Fp, Gs, Gg, Gs, Gd, Gd^Fp, Gs^Fp, Gg, Gg, Re, Gs^Esd, Gs, Re^Edt, Gs, Gs, Gs, Gs, Gg, Re, Gll, Gll^Edt, Gll^Edt, Gs^Fp, Gs^Fp
Gs^Fp, Gs^Fp, Gs^Fp, Gs^Fp, Gs^Fp, Gs^Fp, Gd, Gs, Gg, Gg, Gg, Gg, Gg, Gg, Re, Re, Gg, Re, Re, Gs, Re, Gs, Gg, Gs^Fp, Gs^Fp, Gg, Gll, Gll^Edt, Gll^Edt, Gs^Fp, Gs^Fp
Gs^Fp, Gs^Fp, Gs^Fp, Gs^Fp, Gs^Fp, Gd, Gs^Fp, Gs^Fp, Gs, Gs, Gg, Gg^Efm, Re, Re, Gg^Efm, Gg, Gs, Gg, Gg^Efm, Re, Gg, Re, Re, Gg, Gg^Efm, Gg, Gg, Gll, Gs^Fp, Gs^Fp, Gs^Fp
Gg, Gs^Fp, Gs^Fp, Gs, Gs^Fp, Gs^Fp, Gs^Fp, Gs, Gs, Gg^Efm, Gg^Efm, Re, Gg, Gg, Gs, Gs, Gs^Efm, Gs, Gs, Gg, Gs, Re, Gg, Re, Re, Gg, Gg^Efm, Gg, Gg^Efm, Gg, Gs^Fp
Gs^Fp, Gs^Fp, Gs^Fp, Gs^Fp, Gs^Fp, Gs^Fp, Gs^Fp, Gs^Fp, Gs^Fp, Gs, Gg^Efm, Re, Re, Gs, Gs, Gs, Gg, Gs, Gs, Gs, Gs, Gs, Gg, Gg, Re, Re, Re, Gg, Gg, Gg, Gg
Gg, Gs^Fp, Gs^Fp, Gs^Fp, Gs^Fp, Gs^Fp, Gg, Gs^Fp, Gg, Gs^Fp, Gg, Gg, Re, Gs, Gg, Gs, Gg, Gs, Gg, Gs, Gg, Gg, Gg, Gg, Gg, Re, Re, Gg, Gg, Gg^Efm, Gg
