Mm, Mm, Mm, Mm, Mm, Mm, Hh, Hh, Hh, Hh, Hh, Hh, Hh, Gll^Fp, Gll^Fp, Gs, Gs, Gs, Gs, Gll^Fp, Gll^Fp, Gll^Fp, Gll^Fp, Gs, Gll^Fp, Gs, Gs, Gs, Gs, Gs, Gs
Mm, Mm, Mm, Mm, Mm, Mm, Hh, Hh, Gll^Fp, Gll^Fp, Gll^Fp, Hh, Gll^Fp, Gll^Fp, Gs, Gs, Gs, Gs, Gs, Gs, Gs, Gs, Gs, Gs, Gs, Gs, Gs, Re, Re, Re, Gs
Mm, Mm, Hh, Mm, Mm, Mm, Hh, Hh, Hh, Gs, Gs, Gll^Fp, Gs, Gll^Fp, Gs, Gs, Gs, Gs, Gs, Gs, Gs, Gs, Gs, Gs, Gs, Gs, Re, Re, Gs, Gs, Gs
Hh, Hh, Gs, Hh, Hh, Hh, Hh, Hh, Mm, Hh, Hh, Gs, Gs, Gs, Gs, Gs, Gs, Gs, Gs, Gs, Gs, Gs, Gs, Gs, Gs, Re, Gs, Gs, Gs, Gll^Fp, Gs
Re, Re, Hh, Re, Re, Hh, Hh, Mm, Mm, Mm, Hh, Gll^Fp, Gs, Gs, Gs, Gs, Gs, Gs, Gs, Gs, Gs, Gs, Re, Re, Gs, Gs, Gs, Gs, Gll^Fp, Gll^Fp, Gs
Gs, Gs, Mm, Hh, Hh, Gs, Gs, Mm, Mm, Mm, Hh, Gll^Fp, Gs, Gs, Re, Gs, Re, Gs, Re, Re, Gs, Gs, Gs, Re, Gs, Gs, Gs, Gs, Gll^Fp, Gll^Fp, Gs
Mm, Mm, Mm, Mm, Hh, Hh, Re, Hh, Hh, Hh, Gs, Gs, Re, Re, Gs, Gs, Gs, Re, Gs, Gs, Gs, Gs, Gs, Re, Gs, Gs, Gs, Gs, Gll^Fp, Gll^Fp, Gll^Fp
Mm, Mm, Mm, Mm, Hh, Hh, Hh, Re, Re, Re, Re, Gs, Gs, Gs, Gs, Gs, Gs, Gs, Gs, Gs, Gs, Gs, Gs, Re, Re, Gs, Gs, Gs, Gs, Gll^Fp, Gll^Fp
Mm, Mm, Hh, Hh, Hh, Hh, Gll^Fp, Gs, Gs, Gs, Gs, Gs, Gs, Gll^Fp, Gll^Fp, Gll^Fp, Gs, Gll^Fp, Gs, Gll^Fp, Gs, Gs, Gs, Gs, Re, Re, Gs, Gs, Gs, Gs, Gs
Mm, Hh, Hh, Hh, Hh, Hh, Hh, Gll^Fp, Gll^Fp, Gll^Fp, Gll^Fp, Gll^Fp, Gll^Fp, Gll^Fp, Gll^Fp, Gll^Fp, Gll^Fp, Gll^Fp, Gll^Fp, Gll^Fp, Gll^Fp, Gll^Fp, Gll^Fp, Gs, Gs, Re, Gs, Gs, Gs, Gll^Fp, Gll^Fp
Hh, Hh, Hh, Gll^Fp, Gll^Fp, Gll^Fp, Gll^Fp, Hh, Hh, Gll^Fp, Gll^Fp, Gll^Fp, Gll^Fp, Gll^Fp, Gll^Fp, Gll^Fp, Gll^Fp, Gll^Fp, Gll^Fp, Gll^Fp, Gll^Fp, Gll^Fp, Gs, Gs, Re, Re, Gs, Gs, Gll, Gll^Fp, Gll
Gll^Fp, Gll^Fp, Hh, Hh, Gll^Fp, Gll^Fp, Gll^Fp, Gll^Fp, Gll^Fp, Gll^Fp, Gll^Fp, Gll^Fp, Gll^Fp, Gll^Fp, Gll, Gll^Fp, Gll^Fp, Gll^Fp, Gll^Fp, Gll^Fp, Gll^Fp, Gll^Fp, Gs, Gs, Re, Gs, Gs, Gs, Gll, Gll, Gll
Hh, Gll^Fp, Gll^Fp, Gll^Fp, Gll^Fp, Gll^Fp, Gll^Fp, Gll^Fp, Gll^Fp, Gll^Fp, Gll^Fp, Gll^Fp, Gll^Fp, Gll, Gll, Gll, Gll, Gll, Gll, Gll^Fp, Gs, Gs, Gs, Re, Gll, Gll, Gll, Gll^Fp, Gll^Fp, Gll, Gll
Hh, Hh, Gll^Fp, Gll^Fp, Gll, Gll, Gll, Gll, Gll, Gll^Fp, Gll^Fp, Gll^Fp, Gll, Gll, Gll, Gll, Gll, Gll, Gll, Gs, Gs, Gs, Re, Re, Gll, Gll, Gll, Gll^Fp, Gll^Fp, Gll, Gll
Hh, Hh, Gll^Fp, Gll^Fp, Gll, Gll, Gll, Gll, Gll, Gll^Fp, Gll, Gll, Re, Gll, Gll, Re, Gll, Gll, Gs, Gs, Gs, Gs, Re, Re, Re, Re, Gll, Gll, Gll^Fp, Gll^Fp, Gll^Fp
Gll^Fp, Gll^Fp, Gll^Fp, Gs, Gll, Gll, Gll, Gll, Gs, Gll, Gll, Gll, Gll, Re, Re, Re, Gs, Gs, Gs, Gs, Gll, Re, Gs, Gs, Gs, Re, Gll, Gll, Gll^Fp, Gll^Fp, Gll^Fp
Gll^Fp, Gs, Gs, Gs, Gs, Gll, Gll, Gll, Gs, Gll, Gll, Gll, Gll, Gs, Gll, Re, Re, Gs, Gs, Gs, Rb, Re, Gs, Gs, Gs, Gll, Gll, Gll, Gll^Fp, Gll^Fp, Gll^Fp
Gs, Gs, Gs, Gs, Gs, Gs, Gs, Gs, Gs, Gs, Gs, Gs, Gs, Gs, Gs, Gs, Gs, Re, Re, Re, Rb, Re, Re, Gs, Gs, Gs, Gll^Fp, Gll^Fp, Gll^Fp, Gll^Fp, Gll^Fp
Gs, Gs, Gs, Gs, Gs, Gs, Gs, Gs, Gs, Gs, Gs, Gs, Gs, Gs, Gs, Gs, Gs, Re, Co, Co, Rb, Cer, Re, Gs, Gs, Gs, Gll^Fp, Gll^Fp, Gll^Fp, Gll^Fp, Gll^Fp
Gs, Gs, Gs, Gs, Gs, Gs, Gs, Gs, Gs, Gs, Gs, Gs, Gs, Gs, Gs, Gs, Re, Re, Cer, Ket, Rb, Ce, Gs, Re, Re, Gs, Gs, Gll^Fp, Gll^Fp, Gll^Fp, Gll^Fp
Gs, Gs, Gs, Gs, Gs, Gs, Gs, Gs, Gs, Gs, Gs, Gs, Gs, Gs, Gs, Gs, Re, Re, Rb, Ce, Cer, Co, Gs, Gs, Re, Gs, Gs, Gll^Fp, Gll^Fp, Gll^Fp, Gll^Fp
Gs, Gs, Gs, Gs, Gs, Gs, Gs, Gs, Gs, Gs, Gs, Gs, Gs, Gs, Gs, Gs, Re, Gs, Gs, Re, Gs, Gs, Gs, Gs, Gs, Re, Gll, Gll, Gll, Gll^Fp, Gll^Fp
Gs, Gs, Gs, Gs, Gs, Gs, Gs, Gs, Gs, Gs, Gs, Gs, Gs, Gs, Re, Re, Gs, Re, Re, Gs, Re, Gs, Gs, Gs, Gs, Gs, Gll, Gll, Gll, Gll^Fp, Gll^Fp
Gs, Gs, Gs, Gs, Gs, Gs, Gs, Gs, Gs, Gs, Gs, Gs, Re, Re, Gs, Gs, Gs, Gs, Gs, Re, Gs, Re, Re, Gs, Gs, Gs, Gs, Gll, Gll^Fp, Gll^Fp, Gll^Fp
Gs, Gs, Gs, Gs, Gs, Gs, Gs, Gs, Gs, Gs, Gs, Re, Gs, Gs, Gs, Gs, Gs, Gs, Gs, Gs, Gs, Re, Gs, Re, Re, Gs, Gs, Gs, Gs, Gs, Gll^Fp
Gs, Gs, Gs, Gs, Gs, Gs, Gs, Gs, Gs, Gs, Gs, Re, Re, Gs, Gs, Gs, Gs, Gs, Gs, Gs, Gs, Gs, Gs, Gs, Re, Re, Re, Gs, Gs, Gs, Gs
Gs, Gs, Gs, Gs, Gs, Gs, Gs, Gs, Gs, Gs, Gs, Gs, Re, Gs, Gs, Gs, Gs, Gs, Gs, Gs, Gs, Gs, Gs, Gs, Gs, Re, Re, Gs, Gs, Gs, Gs
