Gg^Fp, Gg^Fp, Gg^Fp, Gg^Fp, Gg^Fp, Gg^Fp, Gg^Fp, Mm, Mm, Mm, Mm, Mm, Hh, Mm, Mm, Mm, Mm, Mm^Xm, Mm^Xm, Mm^Xm, Mm^Xm, Mm, Mm^Xm, Mm^Xm, Mm^Xm, Gs^Fp, Mm^Xm, Wwg, Ww, Ww, Ww, Ww, Mm^Xm, Mm^Xm, Mm^Xm, Mm^Xm, Mm^Xm, Mm^Xm, Mm, Mm, Mm, Gg^Fp, Gg^Fp, Gg^Fp, Gg^Fp, Gg^Fp, Gg^Fp, Gg^Fp, Gg, Gg, Gg, Gg, Gg, Gg
Gg^Fp, Gg^Fp, Gg^Fp, Gg^Fp, Gg^Fp, Gg^Fp, Gg^Fp, Gg^Fp, Gg^Fp, Mm, Mm, Hh, Hh, Hh, Hh, Mm, Hh, Mm, Mm, Mm^Xm, Mm^Xm, Mm^Xm, Mm^Xm, Mm^Xm, Mm^Xm, Mm^Xm, Ww, Ww, Ww, Ww, Mm^Xm, Mm^Xm, Mm^Xm, Mm^Xm, Mm, Mm, Mm, Mm, Hh, Mm, Hh, Hh, Gg^Fp, Gg^Fp, Gg^Fp, Gg^Fp, Gg^Fp, Gg^Fp, Gg, Gg, Ce, Ce, Ce, Gg
Ww, Gg^Fp, Ww, Ww, Ww, Ww, Ww, Gg^Fp, Gg^Fp, Gg^Fp, Gg^Fp, Hh, Hh, Mm, Mm, Hh, Hh, Hh, Mm, Mm, Mm^Xm, Mm^Xm, Mm^Xm, Mm^Xm, Mm^Xm, Wwrg, Ww, Ww, Wwrg, Mm^Xm, Mm, Mm, Mm, Mm, Hh, Hh^Fp, Hh^Fp, Hh, Gg^Fp, Hh^Fp, Hh, Gg^Fp, Gg^Fp, Gg^Fp, Gg, Gg, Gg, Gg, Gg, Gg, Ce, 2 Ke, Ce, Gg
Ww, Ww, Ww, Ww, Ww, Ww, Ww, Ww, Ww, Gg^Fp, Gg^Fp, Gg^Fp, Gg^Fp, Hh, Hh, Hh, Hh, Hh, Mm, Mm, Mm^Xm, Mm^Xm, Mm^Xm, Mm^Xm, Wwrg, Ww, Ww, Wwg, Mm, Mm, Hh, Mm, Hh, Hh, Hh^Fp, Hh^Fp, Hh^Fp, Hh^Fp, Gg^Fp, Gg^Fp, Gg^Fp, Gg^Fp, Gg^Fp, Gg^Fp, Gg, Gg, Gg, Gg, Gg, Gg, Re, Ce, Gg, Gg
Ww, Ww, Ww, Ww, Ww, Ww, Ww, Ww, Ww, Gg^Fp, Gg^Fp, Gg^Fp, Gg^Fp, Gg^Fp, Gg^Fp, Hh, Hh, Hh, Mm, Mm, Mm, Mm^Xm, Mm^Xm, Mm^Xm, Ww, Ww, Wwg, Mm, Hh, Hh, Hh^Fp, Hh, Gg^Fp, Gg^Fp, Gg^Fp, Hh^Fp, Gg^Fp, Hh^Fp, Gg^Fp, Gg^Fp, Gg^Fp, Gg^Fp, Gg, Gg, Gg, Gg, Gg, Gg, Re, Re, Gg, Gg, Gg, Gg
Ww, Ww, Ww, Ww, Ww, Ww, Ce, Ww, Gg^Fp, Gg^Fp, Gg^Fp, Gg^Fp, Gg^Fp, Gg^Fp, Gg^Fp, Gg^Fp, Gg^Fp, Hh, Mm, Mm, Mm, Mm^Xm, Mm^Xm, Ww, Ww, Ww, Hh, Hh^Fp, Gg^Fp, Gg^Fp, Ce, Gg^Fp, Gg^Fp, Gg^Fp, Gg^Fp, Gg^Fp, Gg^Fp, Hh, Gg^Fp, Gg^Fp, Gg^Fp, Gg^Fp, Gg, Gg, Gg, Gg, Re, Re, Gg, Gg, Gg, Gg, Gg^Fp, Gg^Fp
Ww, Ww, Ww, Ww, Gg^Fp, Ce, 6 Ke, Ce, Gg^Fp, Gg^Fp, Gg^Fp, Gg^Fp, Gg^Fp, Gg^Fp, Gg^Fp, Gg^Fp, Gg^Fp, Hh, Mm, Mm, Mm, Mm^Xm, Mm^Xm, Ww, Ww, Wwg, Hh^Fp, Gg^Fp, Gg^Fp, Ce, 3 Ke, Ce, Ce, Gg^Fp, Gg^Fp, Gg^Fp, Gg^Fp, Gg^Fp, Gg^Fp, Hh^Fp, Gg^Fp, Gg^Fp, Gg, Gg, Gg, Re, Gg, Gg, Gg, Gg, Gg, Gg, Gg^Fp, Gg^Fp
Ww, Ww, Ww, Gg^Fp, Gg^Fp, Ce, Ce, Ce, Gg^Fp, Gg^Fp, Gg^Fp, Gg^Fp, Gg^Fp, Gg^Fp, Gg^Fp, Gg^Fp, Gg^Fp, Gg^Fp, Mm, Mm, Mm^Xm, Mm^Xm, Wwrg, Ww, Ww, Wwg, Gg^Fp, Gg^Fp, Gg^Fp, Ce, Re, Gg, Gg, Gg, Gg, Gg^Fp, Gg^Fp, Gg^Fp, Hh^Fp, Hh^Fp, Gg^Fp, Gg^Fp, Gg, Gg, Gg, Re, Gg, Gg, Gg, Gg, Gg, Gg, Gg^Fp, Gg^Fp
Ww, Ww, Ww, Gg^Fp, Gg^Fp, Gg^Fp, Gg^Fp, Re, Re, Gg^Fp, Gg^Fp, Gg^Fp, Gg^Fp, Gg^Fp, Gg^Fp, Gg^Fp, Gg^Fp, Gg^Fp, Mm, Mm, Mm^Xm, Mm^Xm, Ww, Ww, Wwg, Gg^Fp, Gg^Fp, Gg^Fp, Gg, Ce, Re, Gg, Gg, Gg, Gg, Gg, Gg^Fp, Gg^Fp, Hh^Fp, Hh, Gg^Fp, Gg^Fp, Gg, Gg, Gg, Re, Gg, Gg, Gg, Gg, Gg, Gg, Gg^Fp, Gg^Fp
Ww, Ww, Ww, Ww, Gg^Fp, Gg^Fp, Gg^Fp, Gg^Fp, Gg^Fp, Re, Gg^Fp, Gg^Fp, Gg^Fp, Gg^Fp, Gg^Fp, Gg^Fp, Gg^Fp, Gg^Fp, Gg^Fp, Mm, Ww, Ww, Ww, Ww, Gg^Fp, Gg^Fp, Gg, Gg, Gg, Gg, Re, Gg, Gg, Gg, Gg, Gg^Fp, Gg^Fp, Hh, Gg^Fp, Gg^Fp, Gg^Fp, Gg, Gg, Gg, Gg, Re, Gg, Gg, Gg, Gg, Gg^Fp, Gg^Fp, Gg^Fp, Gg^Fp
Ww, Ww, Ww, Ww, Ww, Gg^Fp, Ww, Gg^Fp, Ww, Re, Ww, Gg^Fp, Ww, Gg^Fp, Ww, Gg^Fp, Ww, Ww, Ww, Ww, Ww, Ww, Ww, Wwg, Gg^Fp, Gg^Fp, Gg, Gg, Gg, Gg, Re, Gg, Gg, Gg, Gg, Gg^Fp, Gg^Fp, Gg^Fp, Gg^Fp, Gg^Fp, Gg, Gg, Gg, Gg, Gg, Re, Gg, Gg, Gg, Gg, Gg^Fp, Gg^Fp, Hh^Fp, Hh
Ww, Ww, Ww, Ww, Ww, Ww, Ww, Ww, Ww, Ww^Bw|, Ww, Ww, Ww, Ww, Ww, Ww, Ww, Ww, Gg^Fp, Ww, Gg^Fp, Ww, Ww, Gg^Fp, Gg^Fp, Gg^Fp, Gg, Gg, Gg, Gg, Re, Gg, Gg, Gg, Gg, Gg^Fp, Gg, Gg^Fp, Gg, Gg, Gg, Gg, Gg, Gg, Re, Re, Gg, Gg, Gg, Gg^Fp, Gg^Fp, Gg^Fp, Hh^Fp, Hh
Ww, Ww, Ww, Ww, Ww, Ww, Ww, Ww, Ww, Ww^Bw|, Ww, Ww, Ww, Ww, Gg, Ww, Gg^Fp, Gg^Fp, Gg^Fp, Gg^Fp, Gg^Fp, Ww, Ww, Gg^Fp, Gg^Fp, Gg, Gg, Gg, Gg, Gg, Re, Gg, Gg, Gg, Gg, Gg, Gg, Gg, Gg, Gg, Gg, Gg, Re, Re, Gg, Gg, Gg, Gg, Gg, Gg, Gg^Fp, Hh, Hh^Fp, Hh
Gg^Fp, Gg^Fp, Gg^Fp, Gg^Fp, Gg^Fp, Gg^Fp, Gg, Gg, Gg, Re, Gg, Gg, Gg, Gg, Gg, Gg, Gg, Gg^Fp, Gg^Fp, Gg^Fp, Ww, Ww, Ww, Gg^Fp, Gg, Gg, Gg, Gg, Re, Re, Gg, Gg, Gg, Gg, Gg, Gg, Gg, Gg, Gg, Gg, Re, Re, Gg, Gg, Gg, Gg, Gg^Fp, Gg^Fp, Gg^Fp, Gg^Fp, Mm, Hh, Mm, Mm
Gg^Fp, Gg^Fp, Gg^Fp, Gg^Fp, Gg^Fp, Gg, Gg, Gg, Gg, Re, Re, Ce, Ce, 5 Ke, Ce, Gg, Gg, Gg, Gg, Gg^Fp, Ww, Ww, Gs^Fp, Gg, Gg, Gg, Gg, Re, Gg, Gg, Gg, Gg, Gg, Gg, Gg, Gg, Gg, Gg, Re, Re, Gg, Gg, Gg, Gg, Gg^Fp, Gg, Gg^Fp, Gg^Fp, Hh, Hh, Mm, Mm, Mm, Mm
Gg^Fp, Gg^Fp, Gg^Fp, Gg^Fp, Gg^Fp, Gg, Gg, Gg, Gg, Gg, Gg, Re, Re, Ce, Ce, Ce, Re, Re, Re, Gg, Ww, Ww, Gg, Gg, Gg, Gg, Gg, Re, Gg, Gg, Gg, Gg, Gg, Gg, Gg, Gg, Re, Re, Gg, Gg, Gg, Gg, Gg^Fp, Gg, Gg^Fp, Hh^Fp, Hh^Fp, Hh^Fp, Hh^Fp, Mm, Mm, Mm, Mm, Mm
Gg^Fp, Gg^Fp, Gg^Fp, Gg^Fp, Gg^Fp, Gg, Gg, Gg, Gg, Gg, Gg, Gg, Gg, Re, Re, Re, Gg, Gg, Gg, Re, Ww^Bw\, Ww, Gg, Gg, Gg, Gg, Gg, Re, Gg, Gg, Gg, Gg, Gg, Gg, Re, Re, Gg, Gg, Gg, Gg, Gg, Gg, Gg, Gg^Fp, Gg, Hh, Hh, Hh^Fp, Hh^Fp, Mm, Mm, Mm, Mm, Mm
Gg^Fp, Gg^Fp, Gg^Fp, Gg^Fp, Gg^Fp, Gg^Fp, Gg, Gg, Gg, Gg, Gg, Gg, Gg, Gg, Gg, Gg, Gg, Gg, Gg^Fp, Gg, Ww, Ww^Bw\, Re, Gg, Gg, Gg, Gg, Re, Gg, Gg, Gg, Gg, Re, Re, Gg, Gg, Gg, Gg, Gg, Gg, Gg, Gg, Gg, Gg, Gg, Gg, Gs^Fp, Hh, Mm, Mm, Mm, Mm, Mm, Mm
Gg^Fp, Gg^Fp, Gg^Fp, Gg^Fp, Gg^Fp, Gg^Fp, Gg^Fp, Gg, Gg, Gg, Gg, Gg, Gg, Gg, Gg, Gg, Gg^Fp, Gg^Fp, Gg^Fp, Gg^Fp, Ww, Ww, Gg, Re, Re, Gg, Re, Re, Re, Gg, Re, Re, Gg, Gg, Gg, Gg, Gg, Gg, Gg, Gg, Gg, Gg, Gg, Gg, Gg, Gg, Hh, Hh, Mm, Mm, Mm, Mm, Mm, Mm
Gg^Fp, Gg^Fp, Gg^Fp, Gg^Fp, Gg^Fp, Gg^Fp, Gg^Fp, Gg^Fp, Gg^Fp, Gg, Gg^Fp, Gg, Gg^Fp, Gg, Gg^Fp, Gg^Fp, Gg^Fp, Gg^Fp, Gg^Fp, Ww, Ww, Ww, Gg, Gg, Gg, Re, Gg, Gg, Gg, Re, Gg, Gg, Gg, Gg, Gg, Gg, Hh, Gg, Hh, Gg, Hh, Gg, Gg, Gg, Gg, Gg, Hh, Mm, Mm, Mm, Mm, Mm, Mm, Mm
Gg^Fp, Gg^Fp, Gg^Fp, Gg^Fp, Gg^Fp, Gg^Fp, Gg^Fp, Gg^Fp, Gg^Fp, Gg^Fp, Gg^Fp, Gg^Fp, Gg^Fp, Gg^Fp, Gg^Fp, Gg^Fp, Gg^Fp, Gg^Fp, Ww, Ww, Ww, Gg, Gg, Gg, Gg, Re, Gg, Gg, Gg, Gg, Gg, Gg, Gg, Gg, Gg, Gg, Hh, Hh, Mm, Hh, Mm, Hh, Hh, Gg, Hh, Hh, Mm, Mm, Mm, Mm, Mm, Mm, Mm, Mm
Gg^Fp, Gg^Fp, Gg^Fp, Gg^Fp, Gg^Fp, Gg^Fp, Gg^Fp, Gg^Fp, Gg^Fp, Gg^Fp, Gg^Fp, Gg^Fp, Gg^Fp, Gg^Fp, Gg^Fp, Gg^Fp, Ww, Ww, Ww, Ww, Gg^Fp, Gg, Gg, Gg, Gg, Re, Gg, Gg, Gg, Gg, Gg, Gg, Gg^Fp, Gg^Fp, Gg^Fp, Hh, Hh, Hh, Mm, Mm, Mm, Mm, Mm, Hh, Hh, Hh, Hh^Fp, Mm, Mm, Mm, Mm, Mm, Mm, Mm
Hh, Gg^Fp, Gg^Fp, Gg^Fp, Gg^Fp, Gg^Fp, Gg^Fp, Gg^Fp, Gg^Fp, Gg^Fp, Gg^Fp, Gg^Fp, Gg^Fp, Gg^Fp, Ww, Ww, Ww, Ww, Gg^Fp, Gg^Fp, Gg^Fp, Gg, Gg, Gg, Gg, Re, Re, Gg, Gg, Gg, Gg, Gg^Fp, Gg, Gg^Fp, Hh^Fp, Hh, Mm, Mm, Mm, Mm, Mm, Mm, Mm, Mm, Hh, Hh, Hh, Mm, Mm, Mm, Mm, Mm, Mm, Mm
Hh, Hh, Hh, Gg^Fp, Hh, Hh, Hh, Gg^Fp, Gg^Fp, Gg^Fp, Gg^Fp, Gg^Fp, Gg^Fp, Ww, Ww, Ww, Gg^Fp, Gg^Fp, Gg^Fp, Gg^Fp, Gg^Fp, Gg^Fp, Gg, Gg, Gg, Gg, Re, Gg, Gg, Gg, Gg, Gg, Gg, Gg^Fp, Hh^Fp, Hh^Fp, Mm, Mm, Mm, Mm, Mm, Mm, Mm, Mm, Mm, Hh, Hh, Hh^Fp, Mm, Mm, Mm, Mm, Mm, Mm
Gs^Fp, Hh, Gs^Fp, Hh, Hh, Mm, Mm, Hh, Hh, Hh, Gg^Fp, Gg^Fp, Ww, Ww, Ww, Gg^Fp, Gg^Fp, Gg^Fp, Hh^Fp, Hh, Gg^Fp, Gg^Fp, Gg^Fp, Ce, Ce, Ce, Ce, Ce, Gg, Gg, Gg, Gg, Gg, Gg^Fp, Hh, Hh, Mm, Mm, Mm, Mm, Mm, Mm, Hh, Hh^Fp, Hh, Hh, Hh, Hh^Fp, Mm, Mm, Mm, Mm, Mm, Mm
Gs^Fp, Hh, Hh, Gs^Fp, Hh, Mm, Mm, Hh, Gg^Fp, Gg^Fp, Gg^Fp, Gg^Fp, Ww, Ww, Gg^Fp, Gg^Fp, Hh^Fp, Hh^Fp, Hh^Fp, Hh^Fp, Hh^Fp, Gg^Fp, Gg^Fp, Gg^Fp, Gg^Fp, 4 Ke, Ce, Gg^Fp, Gg^Fp, Gg^Fp, Gg^Fp, Gg^Fp, Hh, Hh, Hh, Mm, Mm, Mm, Mm, Mm, Mm, Mm, Hh^Fp, Hh^Fp, Mm, Hh, Mm, Hh, Hh, Mm, Mm, Mm, Mm, Mm
Hh, Gs^Fp, Gs^Fp, Gs^Fp, Hh, Mm, Hh, Gg^Fp, Gg^Fp, Gg^Fp, Gg^Fp, Gg^Fp, Ww, Ww, Gg^Fp, Gg^Fp, Hh^Fp, Gs^Fp, Hh^Fp, Hh^Fp, Hh^Fp, Gg^Fp, Gg^Fp, Gg^Fp, Gg^Fp, Gg^Fp, Gg^Fp, Gg^Fp, Hh^Fp, Gg^Fp, Hh^Fp, Hh^Fp, Hh^Fp, Hh, Hh, Hh, Mm, Mm, Mm, Mm, Mm, Mm, Mm, Hh^Fp, Hh^Fp, Mm, Mm, Hh, Hh, Mm, Mm, Mm, Mm, Mm
Hh, Hh, Mm, Hh, Gs^Fp, Hh, Gs^Fp, Hh, Hh, Gg^Fp, Gg^Fp, Gg^Fp, Ww, Ww, Gg^Fp, Hh^Fp, Gs^Fp, Gs^Fp, Hh, Gs^Fp, Hh^Fp, Hh^Fp, Hh^Fp, Gg^Fp, Gg^Fp, Gg^Fp, Hh^Fp, Hh^Fp, Gs^Fp, Hh^Fp, Gs^Fp, Hh^Fp, Hh, Hh, Hh, Hh, Mm, Mm, Mm, Mm, Mm, Mm, Hh^Fp, Hh, Hh, Mm, Mm, Mm, Mm, Hh, Mm, Mm, Mm, Mm
Mm, Mm, Mm, Hh, Hh, Gs^Fp, Hh, Hh, Hh, Hh, Hh, Gg^Fp, Ww, Ww, Gg^Fp, Hh^Fp, Hh, Hh, Mm, Hh^Fp, Hh, Hh^Fp, Hh^Fp, Hh^Fp, Hh^Fp, Hh^Fp, Hh, Hh^Fp, Hh, Hh, Hh, Hh, Hh, Hh, Mm, Hh, Hh, Mm, Hh, Mm, Mm, Mm, Hh^Fp, Hh, Mm, Mm, Mm, Mm, Mm, Hh, Hh, Mm, Mm, Mm
Mm, Mm, Mm, Hh, Hh, Gs^Fp, Gs^Fp, Hh, Hh, Hh, Hh, Gg^Fp, Ww, Ww, Gg^Fp, Hh, Hh, Mm, Mm, Hh, Mm, Hh, Mm, Hh, Hh, Hh, Hh, Hh, Mm, Hh, Hh, Hh, Mm, Mm, Mm, Hh^Fp, Hh^Fp, Hh, Mm, Mm, Mm, Hh, Hh^Fp, Hh^Fp, Hh^Fp, Mm, Mm, Mm, Mm, Mm, Hh, Ce, Ce, Mm
Mm, Mm, Hh, Hh, Gs^Fp, Gs^Fp, Hh, Gs^Fp, Mm, Mm, Mm, Hh, Ww, Ww, Hh, Hh, Mm, Mm, Mm, Mm, Mm, Mm, Mm, Mm, Mm, Mm, Mm, Mm, Mm, Mm, Mm, Mm, Mm, Mm, Mm, Mm, Mm, Mm, Hh^Fp, Hh, Hh^Fp, Mm, Mm, Mm, Mm, Hh, Hh, Hh, Hh, Hh, Ce, 1 Ke, Ce, Mm
Mm, Mm, Mm, Mm, Mm, Mm, Mm, Mm, Mm, Mm, Mm, Mm, Ww, Ww, Hh, Hh, Hh, Mm, Mm, Mm, Mm, Mm, Mm, Mm, Mm, Mm, Mm, Mm, Mm, Mm, Mm, Mm, Hh, Mm, Mm, Mm, Mm, Mm, Mm, Mm, Hh, Mm, Mm, Mm, Gs^Fp, Mm, Mm, Mm, Mm, Mm, Mm, Mm, Mm, Mm
