Gs, Gs, Gs^Fp, Gs, Gs, Gs^Fp, Gs, Gs, Gs, Gs^Fp, Gs^Fp, Gs^Fp, Gs, Gs, Gs^Fp, Gs^Fp, Wwg, Gs, Wwg, Gs^Fp, Gs^Fp, Gs^Fp, Gs^Fp, Gs^Fp, Gll, Gll, Gll, Gs^Fp, Gs^Fp, Gs^Fp, Gs^Fp, Gs^Fp, Gs^Fp, Gs^Fp, Gs^Fp, Gs^Fp, Gll, Gll, Gll, Gs^Fp, Gs^Fp, Gs^Fp, Gs^Fp, Gs^Fp
Gs, Gs, Hh^Fp, Gs, Gs^Fp, Gs, Gs, Gs, Hh, Hh, Hh^Fp, Gs, Hh, Gs, Gs, Wwg, Wwg, Wwg, Wwg, Wwg, Wwg, Wwg, Gs^Fp, Gs^Fp, Gll, Gll, Gll, Gll, Gll, Gs^Fp, Gs^Fp, Gs^Fp, Gll, Gs^Fp, Gll, Re, Gll^Vo, Gll, Gll, Gll, Gll, Gs^Fp, Gs^Fp, Gs^Fp
Gs, Gs, Gs, Gs, Mm, Hh^Fp, Gs, Gs, Hh, 2 Mm, Gs^Fp, Gs, Mm, Hh, Gs, Wwg, Wwg, Wwg, Wwg, Wwg, Wwg, Wwg, Gs^Fp, Gs^Fp, Gll, Gll^Vo, Gll, Gll, Gll, Gs^Fp, Gs^Fp, Gs^Fp, Gll, Gll, Gll, Gll, Re, Gll, Gll, Gll, Gll, Gs^Fp, Gll, Gs^Fp
Gs, Gs^Fp, Gs, Hh, Hh, Hh^Fp, Gs, Gs, Gs, Hh, Hh, Gs, Gs, Hh, Gs, Gs^Vo, Wwg, Wwg, Wwg, Wwg, Wwg, Wwg, Gs^Fp, Gll, Cer, Re, Gs^Fp, Gs^Fp, Gs^Fp, Gll, Gs^Fp, Gs^Fp, Gs^Fp, Gll, Re, Re, Re, Gll, Gll, Ce, 1 Ke, Gll, Gll, Gs^Fp
Gs, Gs, Hh^Fp, Gs^Fp, Gs, Gs, Gs^Fp, Gs^Fp, Gs^Fp, Gs, Gs, Gs, Hh, Gs, Gs, Gs, Gs^Fp, Wwg, Wwg, Wwg, Wwg, Cer, Cer, Re, Gll, Gll, Gs^Fp, Gs^Fp, Re, Gs^Fp, Gs^Fp, Gs^Fp, Gs^Fp, Gll, Re, Gll, Re, Gll, Ce, Ce, Ce, Ce, Re, Re
Gs, Gs^Fp, Hh^Fp, Hh^Fp, Hh^Fp, Gs^Fp, Hh, Gs^Fp, Gs, Gs, Gs, Gs, Hh^Fp, Hh, Gs, Gs, Gs^Fp, Wwg, Wwg, Wwg, Re, 3 Ket, Cer, Re, Cer, Gll, Re, Re, Gs^Fp, Re, Re, Gs^Fp, Re, Re, Gll, Gll^Vo, Gll, Re, Gll, Gll, Gll, Gll, Gs^Fp, Gs^Fp
Gs^Fp, Hh^Fp, Gs^Fp, Hh^Fp, Gs^Fp, Gs, Hh^Fp, Hh, Mm, Hh, Gs^Fp, Hh^Fp, Gs^Fp, Gs^Fp, Gll, Gs^Fp, Gs^Fp, Gs^Fp, Gs^Fp, Wwg, Gs^Fp, Cer, Gs, Re, Re, Re, Re, Gs^Fp, Gll, Gs^Fp, Cer, Re, Gs^Fp, Gs^Fp, Gll, Gll, Gll, Gll, Gs^Fp, Gs^Fp, Gs^Fp, Gll, Gs^Fp, Gs^Fp
Gs^Fp, Hh^Fp, Gs^Fp, Hh^Fp, Hh, Hh^Fp, Gs^Fp, Gs^Fp, Hh^Fp, Hh^Fp, Gs^Fp, Gs^Fp, Gs^Fp, Gll, Gll, Gs^Fp, Gll, Gs^Fp, Gs^Fp, Gs^Fp, Gll, Gll, Cer, Gll^Fp, Re, Re, Cer, Re, Re, Gll, Gll, Gll, Cer, Gll, Gll, Gll, Gll, Gs^Fp, Hh, Hh, Gs^Fp, Gll, Gs^Fp, Gs^Fp
Hh, Hh, Hh, Hh, Hh, Hh, Hh, Gs^Fp, Hh, Gs^Fp, Gs^Fp, Gs^Fp, Gs^Fp, Gll, Re, Gll^Vo, Gs^Fp, Gs^Fp, Gs^Fp, Gll, Gll, Cer, Gll, Gll^Fp, Re, Gll^Fp, Gll, Gll, Cer, Cer, Cer, Gll, Hh, Gs^Fp, Gs^Fp, Gs^Fp, Gs^Fp, Gs^Fp, Hh, Hh, Hh, Gs^Fp, Gs^Fp, Gs^Fp
Gs^Fp, Hh, Mm, Hh, Mm, Hh, Hh, Hh, Hh, Hh, Hh, Hh, Gll, Gll, Gs^Fp, Re, Re, Gs^Fp, Gll, Re, Gll, Gll, Gll^Fp, Gll^Fp, Re, Gll^Fp, Gll^Fp, Gll, Cer, 4 Ket, Mm, Mm, Mm, Hh, Hh, Gs^Fp, Hh, Gs^Fp, Hh, Hh, Hh, Gs^Fp, Gs^Fp, Gs^Fp
Mm, Mm, Mm, Mm, Mm, Mm, Mm, Mm, Mm, Hh, Mm, Hh, Hh, Gs^Fp, Gs^Fp, Gs^Fp, Re, Gll, Gll, Re, Re, Gll, Re, Re, Re, Gll, Gll, Gll, Gll^Vo, Re, Mm, Mm, Mm, Mm, Mm, Hh, Mm, Hh, Hh, Hh, Hh, Hh, Mm, Mm
Mm, Mm, Md^Xm, Mm, Md^Xm, Md^Xm, Md^Xm, Md^Xm, Md^Xm, Mm^Xm, Co, Hh, Re, Gs^Fp, Re, Re, Gll, Re, Re, Re, Gll^Vo, Re, Gll^Fp, Gll^Fp, Re, Gll^Fp, Gll, Gll, Gll, Gll, Mm, Mm, Mm, Mm, Mm, Mm, Mm, Mm, Mm, Hh, Mm, Hh, Mm, Mm
Md^Xm, Md^Xm, Md^Xm, Md^Xm, Md^Xm, Md^Xm, Md^Xm, Md^Xm, Mm^Xm, Co, Hh, Hh, Co, Re, Re, Gll, Gll, Gll, Gll, Re, Gll, Gll, Gll^Fp, Gll^Fp, Re, Gll^Fp, Gll, Cer, Gll^Fp, Gs^Fp, Gs^Fp, Mm, Mm, Mm, Mm, Mm, Mm, Mm, Mm, Mm, Mm, Mm, Mm, Mm
Md^Xm, Md^Xm, Md^Xm, Md^Xm, Md^Xm, Md^Xm, Mm, Mm, Hh, Co, Hhd, Co, 5 Ko, Co, Hhd, Hhd, Mm, Gll, Gll^Fp, Gll, Gll^Fp, Gll^Fp, Gs^Fp, Re, Gs^Fp, Gs^Fp, Gs^Fp, Gll^Fp, Gs^Fp, Gs^Fp, Hh, Hh, Mm, Mm, Mm, Mm, Mm, Mm, Mm, Mm, Mm, Mm, Mm, Mm
Md^Xm, Md^Xm, Mm, Md^Xm, Mm, Mm, Hh, Hhd, Mm, Gd^Vo, Hh, Co, Co, Co, Hh, Co, Mm^Xm, Mm, Mm, Gll^Fp, Mm, Mm, Hh, Re, Hh, Gs^Fp, Hh, Gs^Fp, Hh, Hh, Hh, Mm, Mm, Mm, Mm, Mm, Mm, Mm, Mm, Mm, Mm, Mm, Mm, Mm
Mm, Mm, Mm, Mm, Mm, Mm, Re, Mm, Mm, Hhd, Re, Re, Mm, Hhd, Co, Co, Md^Xm, Mm^Xm, Mm^Xm, Mm, Mm, Mm, Hh, Re, Re, Hh, Hh, Hh, Mm, Mm, Mm, Mm, Mm, Mm, Mm, Mm, Mm, Mm, Md^Xm, Md^Xm, Md^Xm, Mm, Mm, Mm
Mm, Mm, Hh, Gd^Vo, Gs, Re, Hh, Re, Re, Re, Hh, Mm, Re, Re, Gd^Vo, Mm^Xm, Mm^Xm, Md^Xm, Md^Xm, Mm^Xm, Mm, Mm, Hh, Hh, Hh, Re, Hh, Mm, Hh, Mm, Mm, Mm, Mm, Mm, Md^Xm, Mm, Md^Xm, Md^Xm, Md^Xm, Md^Xm, Md^Xm, Md^Xm, Md^Xm, Mm
Mm, Mm, Gd, Re, Re, Mm, Mm, Gd^Vo, Re, Re, Re, Re, Mm, Hhd, Hh, Hhd, Mm^Xm, Mm^Xm, Mm^Xm, Hh, Mm, Mm, Re, Re, Re, Re, Mm, Mm, Md^Xm, Md^Xm, Md^Xm, Md^Xm, Md^Xm, Md^Xm, Md^Xm, Md^Xm, Md^Xm, Md^Xm, Md^Xm, Md^Xm, Md^Xm, Md^Xm, Md^Xm, Md^Xm
Mm, Hh, Gd^Vo, Hh, Re, Mm, Mm^Xm, Co, Mm^Xm, Mm, Hhd, Re, Mm, Mm, Re, Gd, Co, Co, Co, Re, Hh, Hh, Re, Hh, Hh, Hh, Mm, Mm, Md^Xm, Md^Xm, Md^Xm, Md^Xm, Md^Xm, Md^Xm, Md^Xm, Md^Xm, Md^Xm, Md^Xm, Md^Xm, Md^Xm, Md^Xm, Md^Xm, Md^Xm, Md^Xm
Md^Xm, Hh, Hh, Re, Hhd, Co, Co, Co, Co, Co, Hhd, Re, Re, Re, Mm, Gd^Vo, Co, 7 Ko, Co, Re, Re, Re, Re, Gs, Gs^Fp, Hh, Mm, Md^Xm, Md^Xm, Md^Xm, Md^Xm, Md^Xm, Md^Xm, Md^Xm, Md^Xm, Md^Xm, Md^Xm, Md^Xm, Md^Xm, Md^Xm, Md^Xm, Md^Xm, Md^Xm, Md^Xm
Md^Xm, Md^Xm, Md^Xm, Hhd, Hh, Mm^Xm, Co, 6 Ko, Co, Mm^Xm, Re, Hhd, Gd^Vo, Hh, Mm, Mm, Md^Xm, Co, Md^Xm, Re, Mm, Re, Hh, Gs^Fp, Mm, Mm, Mm, Md^Xm, Md^Xm, Md^Xm, Md^Xm, Md^Xm, Md^Xm, Md^Xm, Md^Xm, Md^Xm, Md^Xm, Md^Xm, Md^Xm, Md^Xm, Md^Xm, Md^Xm, Md^Xm, Md^Xm
Md^Xm, Md^Xm, Md^Xm, Mm, Md^Xm, Co^Vo, Mm^Xm, Co, Mm^Xm, Co^Vo, Md^Xm, Re, Hh, Hhd, Mm, Mm, Md^Xm, Md^Xm, Md^Xm, Mm, Mm, Mm, Mm, Mm, Mm, Mm, Md^Xm, Md^Xm, Md^Xm, Md^Xm, Md^Xm, Md^Xm, Md^Xm, Md^Xm, Md^Xm, Md^Xm, Md^Xm, Md^Xm, Md^Xm, Md^Xm, Md^Xm, Md^Xm, Md^Xm, Md^Xm
Md^Xm, Md^Xm, Md^Xm, Md^Xm, Md^Xm, Md^Xm, Md^Xm, Co^Vo, Md^Xm, Md^Xm, Md^Xm, Md^Xm, Md^Xm, Mm, Md^Xm, Mm, Md^Xm, Md^Xm, Md^Xm, Mm^Xm, Mm^Xm, Mm^Xm, Mm^Xm, Md^Xm, Md^Xm, Md^Xm, Md^Xm, Md^Xm, Md^Xm, Md^Xm, Md^Xm, Md^Xm, Md^Xm, Md^Xm, Md^Xm, Md^Xm, Md^Xm, Md^Xm, Md^Xm, Md^Xm, Md^Xm, Md^Xm, Md^Xm, Md^Xm
Gs, Md^Xm, Mm, Mm, Mm, Mm, Mm, Md^Xm, Md^Xm, Md^Xm, Mm, Md^Xm, Md^Xm, Md^Xm, Md^Xm, Md^Xm, Mm, Md^Xm, Mm, Mm^Xm, Mm^Xm, Mm^Xm, Mm^Xm, Mm^Xm, Mm^Xm, Md^Xm, Mm^Xm, Md^Xm, Mm, Md^Xm, Mm, Md^Xm, Md^Xm, Md^Xm, Md^Xm, Md^Xm, Md^Xm, Md^Xm, Md^Xm, Md^Xm, Md^Xm, Md^Xm, Md^Xm, Md^Xm