Mm, Mm, Mm, Mm, Mm, Mm, Mm, Mm, Mm, Mm, Mm, Mm, Mm, Mm, Mm, Mm, Mm, Mm, Mm, Mm, Mm, Mm, Mm, Mm, Mm, Hh, Mm, Mm, Mm, Hh, Mm, Mm, Mm, Mm, Mm, Mm, Mm, Mm, Mm, Mm, Mm, Hh, Mm, Hh, Mm, Hh, Mm, Xue, Cud, Cud, Cud, Cud
Hh, Mm, Mm, Mm, Mm, Mm, Mm, Mm, Mm, Mm, Mm, Mm, Mm, Mm, Mm, Mm, Mm, Mm, Mm, Mm, Mm, Mm, Mm, Mm, Mm, Mm, Mm, Mm, Mm, Mm, Mm, Mm, Mm, Mm, Mm, Mm, Mm, Mm, Mm, Mm, Mm, Mm, Mm, Mm, Mm, Mm, Mm, Xue, Cud, Cud, Cud, Cud
Hh, Mm, Mm, Mm, Mm, Mm, Mm, Mm, Mm, Mm, Hh, Mm, Hh, Hh, Gll^Fp, Hh, Gll^Fp, Hh, Hh, Mm, Mm, Mm, Mm, Mm, Mm, Mm, Mm, Mm, Mm, Mm, Mm, Mm, Mm, Mm, Mm, Hh, Mm, Mm, Mm, Mm, Mm, Mm, Mm, Mm, Mm, Mm, Mm, Xue, Cud, Kud, Cud, Cud
Gs, Hh, Hh, Mm, Hh, Mm, Hh, Hh, Hh, Hh, Gll^Fp, Hh, Gll^Fp, Gll^Fp, Gll^Fp, Gll^Fp, Hh, Gll^Fp, Gll^Fp, Hh, Hh, Mm, Mm, Mm, Mm, Mm, Mm, Mm, Mm, Mm, Mm, Mm, Hh, Hh, Hh, Hh, Hh, Hh, Mm, Mm, Hh, Mm, Hh, Mm, Hh, Mm, Xue, Xue, Uu, Cud, Cud, Cud
Gs, Gll^Fp, Gll^Fp, Hh, Gll^Fp, Hh, Gll^Em, Hh^Es, Gll^Fp, Gll^Fp, Gll^Fp, Gll^Fp, Hh, Gll^Fp, Hh, Gll^Em, Hh, Gll^Fp, Gll^Fp, Gll^Fp, Hh, Hh, Mm, Mm, Mm, Mm, Mm, Mm, Mm, Mm, Hh, Hh, Gll^Fp, Gll^Fp, Gll^Fp, Gll^Fp, Gll^Fp, Hh, Gs, Hh, Gs^Em, Gll^Fp, Gll^Fp, Hh, Gs, Gd^Es, Re, Uu, Uu, Uu, Xue, Cud
Gs, Gll^Fp, Gll^Fp, Gll^Fp, Gll^Fp, Gll^Fp, Hh, Hh, Hh, Gll^Fp, Hh, Hh, Hh, Hh, Gll^Fp, Hh, Hh, Hh, Hh, Gll^Fp, Gll^Fp, Hh, Hh, Mm, Mm, Mm, Mm, Mm, Mm, Hh, Gll^Edb, Gll^Fp, Gs, Gs^Es, Gs, Gs, Gs, Gs, Gs, Gs, Gs, Gll^Fp, Gs, Gs^Edt, Gs, Gd, Re, Re, Re, Xue, Mm, Xue
Gs, Gg, Gs, Gll, Gs, Gll^Fp, Gll^Fp, Gll^Fp, Gll^Fp, Hh, Gll^Fp, Gll^Fp, Gll^Fp, Hh, Hh^Es, Gll^Fp, Gll^Fp, Hh^Es, Gll^Fp, Gll^Fp, Gll^Fp, Gll^Fp, Hh, Mm, Mm, Mm, Mm, Mm, Mm, Hh, Gll^Fp, Gs^Edb, Gll^Edb, Gs, Gs, Gg, Gll^Fp, Gll^Fp, Hh, Gll^Fp, Gll^Fp, Gs, Gs, Gs^Es, Re, Re, Gd, Gd^Es, Gd^Edt, Hh, Mm, Hh
Wwrg, Gg, Gg, Gs, Gs, Gll^Fp, Gll^Fp, Re, Gs^Es, Gll^Fp, Gs, Gll, Gs, Gll^Fp, Gll^Fp, Gll^Fp, Gll^Fp, Gll^Fp, Gll^Fp, Gll^Fp, Hh, Hh, Hh, Hh^Es, Mm, Mm, Mm, Mm, Hh, Hh, Gll^Fp, Gs^Edb, Gll^Edb, Gll^Fp, Gll^Fp, Gs, Gs, Gll^Fp, Gll^Fp, Hh^Es, Gll^Fp, Gll^Fp, Gs, Gs, Gs^Edt, Gs, Gs, Gs, Hh, Hh, Mm, Mm
Ww, Wwrg, Gg, Gg, Gg, Gs, Gs, Gll^Fp, Gs, Gs, Gs, Gs, Gs, Gs, Gs^Em, Gll^Fp, Gll^Fp, Gll^Em, Gll^Fp, Gll^Fp, Mm, Hh, Hh, Hh, Hh, Mm, Mm, Mm, Hh, Gll^Fp, Hh, Gll^Fp, Hh, Hh, Gll^Fp, Gs, Gs, Gll^Fp, Gll^Fp, Gll^Fp, Gll^Fp, Gll^Fp, Gs, Gs, Gll^Fp, Gll^Fp, Gll^Fp, Gll^Fp, Hh, Mm, Mm, Hh
Ww, Ww, Ww, Gg, Gg, Gg, Gg, Gs, Gs, Gg, Gll^Fp, Gs, Gs, Gs, Gll, Gll^Fp, Gll^Fp, Gll^Fp, Hh, Hh, Mm, Mm, Mm, Hh, Hh, Hh, Hh, Hh^Es, Hh, Hh, Hh, Gll^Fp, Hh, Hh, Gll^Fp, Gs, Gs, Gs, Gs, Gs, Gg, Gll^Fp, Gs, Gs, Gs, Gll^Fp, Gll^Fp, Gll^Fp, Hh, Mm, Hh, Mm
Gll^Fp, Ww, Ww, Ww, Ww, Gg, Gg, Gg, Gll^Fp, Gll^Fp, Gs^Em, Gs, Gs, Gs, Gll^Fp, Gll^Fp, Hh, Hh, Mm, Mm, Mm, Mm, Mm, Mm, Hh, Hh, Gll^Fp, Gll^Fp, Gll^Fp, Gll^Fp, Gll^Fp, Hh, Hh, Hh, Gll^Fp, Gs, Gs, Gs, Gll^Fp, Gg^Edt, Gs, Gg, Gs, Gg, Gll^Fp, Gll^Fp, Gll^Fp, Hh, Mm, Hh, Mm, Mm
Gll^Fp, Gll^Fp, Gll^Fp, Ww, Ww, Ww, Gll^Fp, Gll^Fp, Gll^Fp, Gll^Fp, Gll, Gs, Gll, Gll^Fp, Gll^Fp, Gll^Fp, Mm, Mm, Mm, Mm, Mm, Mm, Mm, Hh, Gll^Fp, Gll^Fp, Gg, Gll^Fp, Gs^Em, Gll^Fp, Gll^Fp, Gll^Fp, Gll^Fp, Gll^Fp, Gs, Gs, Gll^Fp, Gll^Fp, Gll^Fp, Gll^Fp, Gg, Gs, Gs, Gll^Fp, Hh, Gll^Fp, Hh, Hh, Mm, Mm, Mm, Mm
Gll^Fp, Gll^Fp, Gll^Fp, Gll^Fp, Gll^Fp, Ww, Ww, Gll^Fp, Gll^Fp, Gs^Es, Gs, Gg, Gll^Fp, Gll^Fp, Gll^Fp, Gll^Fp, Gll^Fp, Mm, Mm, Mm, Mm, Mm, Hh, Hh, Gll^Fp, Gll^Fp, Gg, Gg, Gll^Fp, Gg, Gg, Gll^Fp, Gs, Gs, Gs, Gll^Fp, Gll^Fp, Gll^Fp, Gg^Es, Gs, Gg, Gs, Gll^Fp, Gll^Fp, Gll^Fp, Hh, Mm, Mm, Mm, Mm, Mm, Mm
Gll^Fp, Gll^Fp, Hh, Gll^Fp, Gll^Fp, Wwrg, Ww, Gll^Fp, Gll^Fp, Gll^Fp, Gs, Gg, Gg, Gll^Fp, Gs^Es, Gll^Fp, Gll^Fp, Hh, Hh, Mm, Hh, Hh, Hh^Es, Hh, Gg^Em, Gll^Fp, Gg, Gg, Gg, Gg, Gg, Gg, Gg, Gg, Gs^Es, Gll^Fp, Gll^Fp, Gll^Fp, Gg, Gs, Gs, Gll^Fp, Gll^Fp, Gll^Fp, Hh, Hh, Mm, Mm, Hh, Mm, Mm, Hh
Gll^Fp, Hh, Hh, Gll^Fp, Gll^Fp, Gll^Fp, Gll^Fp, Ww, Ww, Gs, Gg, Gg, Gg, Gg, Gg, Gs, Gs, Gll^Fp, Gll^Fp, Hh, Gll^Fp, Gll^Fp, Gs, Gs, Gg, Gg, Gg, Gs, Gg, Gg, Gs, Gg, Gg^Efm, Gg, Gg, Gll^Fp, Gll^Fp, Gll^Fp, Gg, Gg, Gs, Gll^Fp, Gll^Fp, Hh, Hh, Mm, Hh, Hh, Hh, Mm, Mm, Mm
Hh, Gll^Fp, Hh^Es, Hh, Hh, Gll^Fp, Gll^Fp, Ww, Ww, Gg, Gg, Gg, Gg^Efm, Gg, Gg, Gg, Gg, Gs, Gg, Gs, Gg, Gg, Gg^Efm, Gg, Gg, Gg, Gll^Fp, Gll^Fp, Gll^Fp, Gll^Fp, Gg, Gg, Gg, Gg, Gg, Gs, Gll^Fp, Gll^Fp, Gg, Gg, Gg, Gll^Fp, Gll^Fp, Hh, Ww, Hh, Ww, Wwrg, Mm, Mm, Mm, Hh
Mm, Hh, Hh, Hh, Gll^Fp, Hh, Gll^Fp, Gll^Fp, Ww, Ww, Gg, Gg, Gg, Gg^Efm, Gg, Gg^Efm, Gg, Gg, Gg^Es, Gg, Gg, Gg^Efm, Gg^Efm, Gg, Gg, Gg, Gll^Fp, Gll^Fp, Ww, Ww, Ww, Ww, Wwf, Wwf, Wwf, Gs, Gll^Fp, Gll^Fp, Gll^Fp, Gs, Gg, Gg, Gs, Gll^Fp, Ww, Wwrg, Ww, Ww^Ewf, Hh, Mm, Mm, Hh
Mm, Mm, Hh, Gll^Fp, Gll^Fp, Hh, Gll^Em, Gll^Fp, Wwrg, Ww, Ww, Gg, Gg, Gg^Efm, Gg, Gg, Gg, Gg, Gg, Gg, Gg, Gg, Gg, Gg, Ww, Ww, Ww, Ww, Ww^Ewl, Ww, Ww, Ww, Wwf, Wwf, Wwf, Ww, Ww, Gll^Fp, Gll^Fp, Gs, Gg, Gg, Gg, Gg^Es, Gg, Ww, Ww, Hh, Mm, Mm, Mm, Mm
Mm, Mm, Mm, Hh, Hh, Gll^Fp, Gll^Fp, Gll^Fp, Gll^Fp, Ww, Ww, Gg, Gg, Gg, Gg, Gg^Esd, Gg, Gg, Gg, Gg, Gg, Gg, Ww, Ww^Ewf, Ww, Ww, Ww, Ww, Gg, Gg, Gg, Gg^Esd, Gg, Gg, Gg, Ww, Ww, Ww, Ww, Gll^Fp, Gll^Fp, Gg, Gg^Efm, Gg, Gg, Gg, Ww, Ww^Ewf, Mm, Mm, Mm, Hh
Mm, Mm, Mm, Mm, Mm, Hh, Gll^Fp, Gll^Fp, Gll^Es, Ww, Ww, Ww, Ww, Ww, Ww, Wwrg, Wwrg, Gg, Wwrg, Gg, Ww, Ww, Ww, Ww, Gll^Fp, Gll^Fp, Gll^Fp, Gg, Hh, Hh, Gll^Fp, Gg, Gg, Gg, Gg, Gg^Efm, Gg^Es, Ww, Ww, Ww, Ww, Gg^Efm, Gg, Gg, Gg, Gg, Gg, Wwrg, Ww, Mm, Ww, Ww
Mm, Mm, Mm, Mm, Mm, Hh, Hh, Gll^Fp, Hh, Gll^Fp, Gg, Ww, Gg, Ww, Gg, Wwrg, Wwf, Wwf, Wwrg, Ww, Ww, Ww, Gll^Fp, Gll^Fp, Hh, Hh, Gll^Fp, Hh, Hh, Gll^Fp, Gll^Fp, Gg, Gg, Gg, Gg, Gg, Gll^Fp, Gll^Fp, Gll^Fp, Ww, Ww, Ww, Ww, Gg, Wwf, Gg, Ww, Ww, Ww, Ww^Ewl, Ww, Ww
Mm, Mm, Mm, Mm, Mm, Hh, Gs^Edb, Hh, Hh, Gg, Gg, Gg, Gs, Gg, Gs, Gg, Gg, Gg, Gs, Gs^Es, Gll^Fp, Gll^Fp, Hh, Hh, Gll^Fp, Hh, Gll^Fp, Gll^Fp, Gll^Fp, Gll^Fp, Gs^Es, Gs, Gg, Gg, Gg, Gg, Gll^Fp, Gll^Fp, Hh, Gll^Fp, Gll^Fp, Ww, Ww, Ww, Wwf, Wwf, Ww, Ww, Ww, Ww, Mm, Mm
Mm, Mm, Mm, Mm, Hh, Hh, Gs, Gs, Gs, Gs, Gs^Es, Gs, Gll^Fp, Gll^Fp, Gll, Gg, Gll^Fp, Gll, Gll^Fp, Gs^Fms, Gll^Fp, Gll^Fp, Hh, Gll^Fp, Gll^Fp, Hh, Hh, Gll^Fp, Gll^Fp, Gll^Fp, Gll^Fp, Gg, Gg, Gg, Gg, Gg, Gll^Em, Gll^Fp, Hh, Gll^Fp, Gll^Fp, Gll^Fp, Gll^Fp, Gg, Gg, Wwf, Gg, Gg^Es, Hh, Mm, Mm, Mm
Mm, Mm, Mm, Mm, Hh, Gs, Gs, Gs, Gs, Gs, Gll^Fp, Gll^Fp, Gll^Fp, Gs^Es, Gs, Gs, Gll^Fp, Gll^Fp, Gll^Fp, Hh, Hh, Hh, Hh, Gll^Fp, Gll^Fp, Hh, Gs^Es, Hh, Gll^Fp, Gll^Fp, Gg^Em, Gll^Fp, Gg, Gg, Gg, Gg, Gll^Fp, Gll^Fp, Hh, Hh, Hh, Hh, Gll^Fp, Gg, Gg, Gg, Gg, Hh, Hh, Mm, Mm, Mm
Mm, Mm, Mm, Mm, Hh, Gll, Gs^Edb, Gs, Gs^Edb, Gll, Gll^Fp, Gll^Fp, Gs, Gs, Gll^Fp, Gll, Gs, Gs, Gll^Fp, Hh, Mm, Mm, Hh, Hh, Gll^Fp, Hh, Hh, Gs, Gs, Gg, Gg^Efm, Gg, Gg, Gg, Gll^Fp, Gll^Fp, Hh, Hh, Mm, Mm, Mm, Hh, Gll^Fp, Gll^Fp, Gg, Gg, Gg, Gll^Fp, Hh, Hh, Mm, Mm
Mm, Mm, Mm, Mm, Hh, Gll^Fp, Gll^Fp, Gs^Es, Gll^Fp, Gll^Fp, Hh, Gll^Fp, Gs^Em, Gll^Fp, Gll, Gll^Fp, Gll^Fp, Gll, Gll^Fp, Hh, Mm, Mm, Mm, Hh, Hh, Hh, Hh, Gll^Fp, Gll^Fp, Gg, Gg, Gg^Efm, Gg, Gg, Gll^Fp, Hh, Gll^Fp, Hh, Hh, Mm, Hh, Hh, Gll^Fp, Gg, Gg, Gg, Gs, Gll^Fp, Hh, Mm, Mm, Mm
Mm, Mm, Mm, Mm, Mm, Hh, Gll^Fp, Gll^Fp, Gll^Fp, Gll^Fp, Hh, Gll^Fp, Gll^Fp, Gs, Gll^Fp, Gs^Es, Gll^Fp, Gll^Fp, Hh, Hh^Es, Mm, Mm, Mm, Mm, Hh, Gll^Fp, Gll^Fp, Hh, Gll^Fp, Gll^Fp, Gll^Fp, Gg, Gg, Gg, Gg, Gll^Fp, Gll^Fp, Hh, Gll^Fp, Hh, Hh, Gll^Fp, Gg, Gg, Gg, Gs, Gll^Fp, Gll^Em, Gll^Fp, Hh, Mm, Mm
Mm, Mm, Mm, Mm, Mm, Mm, Mm, Hh, Hh, Hh, Hh, Gll^Fp, Gll^Fp, Gll^Fp, Gll^Fp, Gll^Fp, Gll^Fp, Hh, Hh, Mm, Mm, Mm, Mm, Mm, Hh, Gll^Fp, Hh, Hh, Hh, Gll^Fp, Gll^Fp, Gg, Gg, Gg, Gg, Gll^Fp, Gll^Fp, Hh, Gll^Em, Gll^Fp, Gll^Fp, Gll^Fp, Gg, Gg, Gg, Gll^Fp, Gll^Fp, Gll^Fp, Gll^Fp, Hh, Mm, Mm
Mm, Mm, Mm, Mm, Mm, Mm, Mm, Mm, Mm, Hh^Es, Mm, Hh, Hh, Gll^Fp, Hh, Gll^Fp, Hh, Hh, Mm, Mm, Mm, Mm, Mm, Mm, Mm, Hh, Hh, Hh, Hh, Hh, Gll^Fp, Gg, Gg, Gs, Gg, Gll^Fp, Gg, Gll^Fp, Gg, Gs, Gg, Gg, Gg, Gg, Gs, Gll^Fp, Gll^Fp, Gll^Em, Gll^Fp, Hh, Mm, Mm
Mm, Mm, Mm, Mm, Mm, Mm, Mm, Mm, Mm, Mm, Mm, Mm, Mm, Mm, Mm, Hh, Mm, Mm, Mm, Mm, Mm, Mm, Mm, Mm, Mm, Mm, Hh, Gll^Fp, Gll^Fp, Gll^Fp, Gs^Em, Gg, Gg, Gs, Re, Gg, Gs, Gg, Gg, Gg, Gg, Gg, Gs, Gs, Gll^Fp, Gll^Fp, Hh, Gll^Fp, Mm, Mm, Mm, Mm
Mm, Mm, Mm, Mm, Mm, Mm, Mm, Mm, Mm, Mm, Mm, Mm, Mm, Mm, Mm, Mm, Mm, Mm, Mm, Mm, Mm, Mm, Mm, Mm, Mm, Mm, Mm, Hh, Hh, Gll^Fp, Gll^Fp, Gg, Gg, Gg^Esd, Gs, Re, Gs, Gg, Gs, Gs, Gll^Fp, Gll^Fp, Gll^Fp, Gll^Fp, Gll^Fp, Gll^Fp, Mm, Mm, Mm, Mm, Mm, Mm
Hh, Mm, Mm, Mm, Mm, Mm, Mm, Mm, Mm, Mm, Mm, Mm, Mm, Mm, Mm, Mm, Mm, Mm, Mm, Mm, Mm, Mm, Mm, Mm, Mm, Mm, Mm, Hh, Hh, Gll^Fp, Gs^Fms, Gll^Fp, Gg, Gg, Gs, Re, Gs, Gg, Gs^Fms, Gll^Fp, Gll^Fp, Gll^Fp, Gll^Fp, Gll^Fp, Mm, Mm, Mm, Mm, Mm, Mm, Mm, Mm
