Gs, Gs, Gs^Fp, Gs, Gs, Gs^Fp, Gs, Gs, Gs, Gs^Fp, Gs^Fp, Gs^Fp, Gs, Gs, Gs^Fp, Gs^Fp, Wwg, Gs, Wwg, Gs^Fp, Gs^Fp, Gs^Fp, Gs^Fp, Gs^Fp, Gll, Gll, Gll, Gs^Fp, Gs^Fp, Gs^Fp, Gs^Fp, Gs^Fp, Gs^Fp, Gs^Fp, Gs^Fp, Gs^Fp, Gll, Gll, Gll, Gs^Fp, Gs^Fp, Gs^Fp, Gs^Fp, Gs^Fp
Gs, Gs, Hh^Fp, Gs, Gs^Fp, Gs, Gs, Gs, Hh, Hh, Hh^Fp, Gs, Hh, Gs, Gs, Wwg, Wwg, Wwg, Wwg, Wwg, Wwg, Wwg, Gll^Fdw, Gs^Fp, Gll, Gll, Gll^Edt, Gll, Gll^Edt, Gs^Fp, Gs^Fp, Gs^Fp, Gll, Gs^Fp, Gll^Edt, Re, Gll^Vo, Gll, Gll^Es, Gll, Gll, Gs^Fp, Gs^Fp, Gs^Fp
Gs, Gs, Gs, Gs, Mm, Hh^Fp, Gs, Gs, Hh, 2 Mm, Gs^Fp, Gs, Mm, Hh, Gs, Wwg, Wwg, Wwg, Wwg, Wwg, Wwg, Wwg, Ss, Gs^Fp, Gll, Gll^Vo, Gll, Gll^Edt, Gll, Gs^Fp, Gs^Fp, Gs^Fp, Gll, Gll^Edt, Gll, Gll, Re, Gll, Gll, Gll^Edt, Gll, Gs^Fp, Gll, Gs^Fp
Gs, Gs^Fp, Gs, Hh, Hh, Hh^Fp, Gs, Gs, Gs, Hh, Hh, Gs, Gs, Hh, Gs, Gs^Vo, Wwg, Wwg, Wwg, Wwg, Wwg, Wwg, Gll^Fdw, Gll^Edt, Cer, Re, Gs^Fp, Gs^Fp, Gs^Fp, Gll, Gs^Fp, Gs^Fp, Gs^Fp, Gll, Re, Re, Re, Gll, Gll, Ce, 1 Ke, Gll, Gll, Gs^Fp
Gs, Gs, Hh^Fp, Gs^Fp, Gs, Gs, Gs^Fp, Gs^Fp, Gs^Fp, Gs, Gs, Gs, Hh, Gs, Gs, Gs, Gs^Fp, Wwg, Wwg, Wwg, Wwg, Ss, Sm, Re, Gll, Gll, Gs^Fp, Gs^Fp, Re, Gs^Fp, Gs^Fp, Gs^Fp, Gs^Fp, Gll, Re, Gll, Re, Gll, Ce, Ce, Ce, Ce, Re, Re
Gs, Gs^Fp, Hh^Fp, Hh^Fp, Hh^Fp, Gs^Fp, Hh, Gs^Fp, Gs, Gs, Gs, Gs, Hh^Fp, Hh, Gs, Gs, Gs^Fp, Wwg, Wwg, Wwg, Re, Rb, Ss, Re, Cer, Gll^Edt, Re, Re, Gs^Fp, Re, Re, Gs^Fp, Re, Re, Gll, Gll^Vo, Gll, Re, Gll, Gll, Gll, Gll, Gs^Fp, Gs^Fp
Gs^Fp, Hh^Fp, Gs^Fp, Hh^Fp, Gs^Fp, Gs, Hh^Fp, Hh, Mm, Hh, Gs^Fp, Hh^Fp, Gs^Fp, Gs^Fp, Gll, Gs^Fp, Gs^Fp, Gs^Fp, Gs^Fp, Wwg, Gll^Fdw, Sm, Gs, Re, Re, Re, Re, Gs^Fp, Gll, Gs^Fp, Gll, Re, Gs^Fp, Gs^Fp, Gll, Gll, Gll^Edt, Gll, Gs^Fp, Gs^Fp, Gs^Fp, Gll, Gs^Fp, Gs^Fp
Gs^Fp, Hh^Fp, Gs^Fp, Hh^Fp, Hh, Hh^Fp, Gs^Fp, Gs^Fp, Hh^Fp, Hh^Fp, Gs^Fp, Gs^Fp, Gs^Fp, Gll^Dr, Gll, Gs^Fp, Gll, Gs^Fp, Gs^Fp, Gs^Fp, Gll^Edt, Gll, Cer, Gll^Fp, Re, Re, Cer, Re, Re, Gll, Gll, Gll, Cer, Gll, Gll^Edt, Gll^Es, Gll, Gs^Fp, Hh, Hh, Gs^Fp, Gll, Gs^Fp, Gs^Fp
Hh, Hh, Hh, Hh, Hh, Hh, Hh, Gs^Fp, Hh, Gs^Fp, Gs^Fp, Gs^Fp, Gs^Fp, Gll^Edt, Re^Edt, Gll^Vo, Gs^Fp, Gs^Fp, Gs^Fp, Gll, Gll, Cer, Gll, Gll^Fp, Re, Gll^Fp, Gll, Gll, Gll, Cer, Gd, Gll, Hh, Gs^Fp, Gs^Fp, Gs^Fp, Gs^Fp, Gs^Fp, Hh, Hh, Hh, Gs^Fp, Gs^Fp, Gs^Fp
Gs^Fp, Hh, Mm, Hh, Mm, Hh, Hh, Hh, Hh, Hh, Hh, Hh, Gll, Gll, Gs^Fp, Re, Re, Gs^Fp, Gll, Re, Gll^Es, Gll^Edt, Gll^Fp, Gll^Fp, Re, Gll^Fp, Gll^Fp, Gll^Edt, Gll^Dr, Gd, Mm, Mm, Mm, Hh, Hh, Gs^Fp, Hh, Gs^Fp, Hh, Hh, Hh, Gs^Fp, Gs^Fp, Gs^Fp
Mm, Mm, Mm, Mm, Mm, Mm, Mm, Mm, Mm, Hh, Mm, Hh, Hh, Gs^Fp, Gs^Fp, Gs^Fp, Re, Gll, Gll^Edt, Re, Re, Gll, Re, Re, Re, Gll, Gll, Gll, Gll^Vo, Re, Mm, Mm, Mm, Mm, Mm, Hh, Mm, Hh, Hh, Hh, Hh, Hh, Mm, Mm
Mm, Mm, Md^Xm, Mm, Md^Xm, Md^Xm, Md^Xm, Md^Xm, Md^Xm, Co, Co, Hh, Re^Es, Gs^Fp, Re, Re, Gll^Edt, Re, Re, Re, Gll^Vo, Re, Gll^Fp, Gll^Fp, Re, Gll^Fp, Gll, Gll^Edt, Gll, Gll^Edt, Mm, Mm, Mm, Mm, Mm, Mm, Mm, Mm, Mm, Hh, Mm, Hh, Mm, Mm
Md^Xm, Md^Xm, Md^Xm, Md^Xm, Md^Xm, Md^Xm, Md^Xm, Md^Xm, Mm^Xm, Co, Hh, Hh, Co, Re, Re, Gll, Gll^Es, Gll^Edt, Gll, Re, Gll^Edt, Gll, Gll^Fp, Gll^Fp, Re, Gll^Fp, Gll, Cer, Gll^Fp, Gs^Fp, Gs^Fp, Mm, Mm, Mm, Mm, Mm^Xm, Mm^Xm, Mm, Mm, Mm, Mm, Mm, Mm, Mm
Md^Xm, Md^Xm, Md^Xm, Md^Xm, Md^Xm, Md^Xm, Mm, Mm, Hh, Co, Hhd, Co, 3 Ko, Co, Hhd, Hhd, Mm, Gll^Es, Gll^Fp, Gll^Dr, Gll^Fp, Gll^Fp, Gs^Fp, Re, Gs^Fp, Gs^Fp, Gs^Fp, Gll^Fp, Gs^Fp, Gs^Fp, Hh, Hh, Mm, Mm, Mm, Mm^Xm, Mm^Xm, Mm, Mm, Mm, Mm, Mm, Mm^Xm, Mm^Xm
Md^Xm, Md^Xm, Mm, Md^Xm, Mm, Mm, Hh, Hhd, Mm, Gd^Vo, Hh, Co, Co, Co, Hh, Co, Co, Mm, Mm, Gll^Fp, Mm, Mm, Hh, Re, Hh, Gs^Fp, Hh, Gs^Fp, Hh, Hh, Hh, Mm, Mm, Mm, Mm^Xm, Mm^Xm, Mm^Xm, Mm^Xm, Mm^Xm, Mm^Xm, Mm^Xm, Mm^Xm, Mm^Xm, Mm^Xm
Mm, Mm, Mm, Mm, Mm, Mm, Re, Mm, Mm, Hhd, Re^Es, Re, Mm, Hhd^Es, Co, Co, Md^Xm, Mm^Xm, Mm^Xm, Mm, Mm, Mm, Hh^Fp, Re, Re, Hh, Hh^Fp, Hh^Fp, Mm, Mm, Mm, Mm, Mm, Mm^Xm, Mm^Xm, Mm^Xm, Mm^Xm, Mm^Xm, Mm^Xm, Mm^Xm, Md^Xm, Mm^Xm, Mm^Xm, Mm^Xm
Mm, Mm, Hh, Gd^Vo, Gs^Edt, Re^Es, Hh, Re^Es, Re, Re, Hh, Mm, Re, Re, Gd^Vo, Mm^Xm, Mm^Xm, Md^Xm, Md^Xm, Mm^Xm, Mm, Mm, Hh^Fp, Hh, Hh^Fp, Re^Es, Hh, Mm, Hh, Mm, Mm, Mm, Mm, Mm^Xm, Mm^Xm, Mm^Xm, Mm^Xm, Mm^Xm, Md^Xm, Md^Xm, Md^Xm, Md^Xm, Md^Xm, Mm^Xm
Mm, Mm, Gd, Re, Re, Mm, Mm, Gd^Vo, Re^Edt, Re^Es, Re, Re, Mm, Hhd, Hh, Hhd, Mm^Xm, Mm^Xm, Mm^Xm, Hh, Mm, Mm, Re, Re, Re, Re, Mm, Mm, Mm, Mm, Mm^Xm, Mm^Xm, Mm^Xm, Mm^Xm, Mm^Xm, Mm^Xm, Mm^Xm, Md^Xm, Md^Xm, Md^Xm, Md^Xm, Mm, Md^Xm, Md^Xm
Mm, Hh, Gd^Vo, Hh^Es, Re, Mm^Es, Mm^Xm, Co, Mm^Xm, Mm, Hhd, Re^Es, Mm, Mm, Re^Edt, Gd, Mm^Xm, Mm^Xm, Mm, Hh, Hh^Fp, Gd^Vo, Re, Mm, Hh^Fp, Hh, Mm, Mm, Mm^Xm, Mm^Xm, Mm^Xm, Mm^Xm, Mm^Xm, Mm^Xm, Md^Xm, Mm^Xm, Mm, Mm, Mm, Md^Xm, Mm, Mm, Mm, Md^Xm
Md^Xm, Hh, Hh, Re^Es, Hhd, Co, Co, Co, Co, Co, Hhd, Re, Re, Re, Mm, Gd^Vo, Mm^Xm, Mm^Xm, Mm, Hh, Re^Es, Re, Re^Es, Gd^Vo, Gg, Hh, Ww, Mm^Xm, Mm^Xm, Mm^Xm, Mm^Xm, Mm^Xm, Mm, Mm, Hh, Hh, Gs^Fp, Hh, Hh^Fms, Hh^Fms, Gs^Fms, Mm, Mm, Md^Xm
Md^Xm, Md^Xm, Md^Xm, Hhd^Edt, Hh, Mm^Xm, Co, 4 Ko, Co, Mm^Xm, Re, Hhd, Gd^Vo, Hh, Mm, Mm, Md^Xm, Mm^Xm, Mm, Hh, Hh, Gd^Vo, Hh, Gg, Ww, Ww, Wo, Mm^Xm, Wo^Xo, Wo, Wo, Wo, Hh, Hh, Gg, Hh^Fms, Gs, Gs, Gs, Gs, Mm, Gs^Fp, Hh^Fp, Mm
Md^Xm, Md^Xm, Md^Xm, Mm, Md^Xm, Co^Vo, Mm^Xm, Co, Mm^Xm, Co^Vo, Md^Xm, Re, Hh, Hhd, Mm^Xm, Mm, Md^Xm, Md^Xm, Md^Xm, Mm, Mm, Mm, Mm, Ww, Wo, Wo, Mm^Xm, Wo, Mm^Xm, Wo, Hh, Wo, Ww, Hh^Efm, Gg, Gs^Efm, Gg^Fms, Gs, Gs, Gs, Gs, Hh^Fp, Gg^Fp, Hh
Md^Xm, Md^Xm, Md^Xm, Md^Xm, Md^Xm, Md^Xm, Md^Xm, Co^Vo, Md^Xm, Md^Xm, Md^Xm, Md^Xm, Md^Xm, Mm, Md^Xm, Mm, Mm, Md^Xm, Mm, Mm, Mm, Mm^Xm, Mm^Xm, Wo, Mm^Xm, Wo, Mm^Xm, Mm^Xm, Mm^Xm, Hh, Hh, Wo, Ww, Gg^Efm, Rb^Gvs, Rb^Gvs, Rb^Gvs, Gs^Vl, Gs, Gs, Gs, Gs^Fms, Gs^Efm, Hh
Gs, Md^Xm, Mm, Mm, Mm, Mm, Mm, Md^Xm, Md^Xm, Md^Xm, Mm, Md^Xm, Md^Xm, Md^Xm, Md^Xm, Md^Xm, Mm^Xm, Mm, Mm^Xm, Mm^Xm, Mm^Xm, Mm^Xm, Mm^Xm, Mm, Mm^Xm, Mm^Xm, Mm, Md^Xm, Mm, Md^Xm, Mm, Md^Xm, Ww, Ww, Rb^Gvs, Rb^Gvs, Rb^Gvs, Gs, Gg^Fp, Gs^Fp, Gs, Gs^Fms, Gs, Hh
